工作	;i
最后	bf
时候	bi
时间	bn
出现	ce
出去	cf
出来	cg
改变	cm
虽然	cn
必要	cq
已经	cs
以为	d;
大家	da
以后	df
知道	dk
现在	ep
地方	f;
不是	gb
不会	gi
不过	gj
不能	gv
进行	hd
进来	hg
他们	ii
什么	ir
今天	it
可以	jd
过去	jf
过来	jg
我们	ji
可能	jv
事情	jy
管理	ke
或者	lf
比较	ll
感觉	lm
学习	mj
需要	mq
问题	nb
然后	nf
那个	ni
那么	nr
多少	nv
那些	nz
只是	ob
因为	qk
自己	rc
所以	rd
即使	ri
所有	rr
应该	ru
怎样	sg
怎么	sr
一定	ta
一下	tf
一样	tg
一个	ti
一种	tt
开始	tx
就是	ub
没有	vr
这儿	wa
这里	we
这样	wg
这个	wi
发展	wp
这么	wr
这种	wt
这些	wz
如果	xb
好像	xi
情况	yk
之后	zf
起来	zg
