一	一ＹＩ
了	乛亅Ｌ
是	日一止
不	不ＢＵ
我	手戈Ｗ
这	文辶Ｚ
在	Ｐ土Ｚ
人	人ＲＮ
有	冃Ｙ
他	亻也Ｔ
来	未丷Ｌ
个	人丨Ｇ
道	首丿辶
你	亻小
大	大ＤＡ
到	一土刂
着	目Ｚ
就	高小尢
上	卜一Ｓ
们	亻门Ｍ
那	月阝Ｎ
也	也ＹＥ
说	讠丷儿
么	丿厶Ｍ
下	下ＸＡ
出	出ＣＵ
然	夕丶灬
地	土也Ｄ
中	口丨Ｚ
看	目Ｋ
时	日寸Ｓ
要	覀女Ｙ
没	氵殳Ｍ
天	一大Ｔ
过	寸辶Ｇ
可	可ＫＥ
自	丿目Ｚ
子	子ＺＩ
能	厶冃匕
还	不辶Ｈ
之	之ＺＩ
以	以ＹＩ
去	土厶Ｑ
好	女子Ｈ
后	Ｆ口Ｈ
为	冫力Ｗ
都	者阝Ｄ
会	人云Ｈ
里	里ＬＩ
心	心ＸＮ
得	彳日寸
对	又寸Ｄ
身	身ＳＮ
手	手ＳＵ
起	走己Ｑ
小	小ＸＯ
想	木目心
只	口八Ｚ
而	丆皿Ｅ
和	禾口Ｈ
头	头ＴＵ
她	女也Ｔ
无	干乚Ｗ
力	力ＬＩ
面	丆罒二
己	己ＪＩ
如	女口Ｒ
现	王见Ｘ
什	亻十Ｓ
样	木羊Ｙ
多	夕夕Ｄ
已	已ＹＩ
知	矢口Ｚ
些	止匕二
经	纟又工
声	声ＳＧ
前	首前Ｑ
神	礻日丨
笑	丿大
事	丁口彐
开	一廾Ｋ
点	占灬Ｄ
方	方ＦＧ
眼	目艮Ｙ
发	发ＦＡ
所	尸斤
但	亻日一
气	气ＱＩ
法	氵土厶
意	立日心
情	忄青Ｑ
两	两ＬＧ
生	丿Ｓ
家	宀豕Ｊ
间	门日Ｊ
将	丬夕寸
很	彳艮Ｈ
真	十且八
话	讠舌Ｈ
成	戊Ｃ
让	讠卜一
被	衤皮Ｂ
老	耂匕Ｌ
动	云力Ｄ
当	彐Ｄ
用	用ＹＧ
于	于ＹＵ
见	见ＪＮ
回	囗口Ｈ
又	又ＹＵ
军	冖车Ｊ
把	扌巴Ｂ
此	止匕Ｃ
才	才ＣＩ
几	几ＪＩ
战	占戈Ｚ
正	一止Ｚ
龙	龙ＬＧ
明	日月Ｍ
从	人人Ｃ
却	土厶卩
长	长ＣＧ
十	十ＳＩ
三	三ＳＮ
女	女ＮＵ
光	一儿
再	王冂Ｚ
向	白口Ｘ
实	宀头Ｓ
最	日耳又
行	彳亍Ｘ
高	高ＧＯ
本	木一Ｂ
打	扌丁Ｄ
定	宀一止
进	井辶Ｊ
魔	广林儿
风	风ＦＧ
给	纟亼口
问	门口Ｗ
国	囗王丶
色	巴Ｓ
同	冂一口
种	禾口丨
走	走ＺＵ
其	其ＱＩ
年	井Ｎ
口	口ＫＵ
王	王ＷＧ
怎	乍心Ｚ
边	力辶Ｂ
次	冫欠Ｃ
全	全ＱＮ
白	白ＢＩ
吧	口巴Ｂ
儿	儿ＥＲ
感	戊一心
果	日木Ｇ
听	口斤Ｔ
啊	口阝可
体	亻木一
外	夕卜Ｗ
死	歹匕Ｓ
飞	乙冫Ｆ
分	分ＦＮ
主	主ＺＵ
觉	学见Ｊ
住	亻主Ｚ
少	少ＳＯ
比	比ＢＩ
空	穴工Ｋ
因	囗大Ｙ
门	门ＭＮ
等	土寸
轻	车又工
直	十且Ｚ
第	弓丿
候	亻尸矢
脸	月亼兴
相	木目Ｘ
强	弓虽Ｑ
何	亻可Ｈ
张	弓长Ｚ
快	忄夬Ｋ
做	亻古攵
重	千里Ｚ
与	与ＹＵ
太	大丶Ｔ
应	广兴Ｙ
刚	冂乂刂
接	扌立女
位	亻立Ｗ
便	亻丈日
量	日一里
更	丈日Ｇ
难	又隹Ｎ
名	夕口Ｍ
二	二ＥＲ
内	内ＮＩ
连	车辶Ｌ
水	水ＳＩ
西	西ＸＩ
黑	黑ＨＩ
马	马ＭＡ
部	立口阝
入	丿丶Ｒ
作	亻乍Ｚ
吗	口马Ｍ
兵	丘八Ｂ
师	刂一巾
虽	虽ＳＩ
别	另刂Ｂ
击	干凵Ｊ
放	方攵Ｆ
完	宀元Ｗ
四	囗儿Ｓ
灵	彐火Ｌ
公	八厶Ｇ
并	首廾Ｂ
先	儿Ｘ
处	夂卜Ｃ
士	士ＳＩ
剑	亼兴刂
算	目廾
东	七小Ｄ
机	木几Ｊ
微	微几Ｗ
城	土戊
火	火ＨＯ
变	亦又Ｂ
叫	口丩Ｊ
清	氵青Ｑ
带	卅冖巾
杀	乂朩Ｓ
斯	其斤Ｓ
李	木子Ｌ
队	阝人Ｄ
云	云ＹＮ
者	者ＺＥ
望	亡月王
原	厂白小
竟	竟ＪＧ
像	亻象Ｘ
惊	忄高小
呢	口尸匕
安	安ＡＮ
山	山ＳＮ
星	日丿
族	族矢Ｚ
海	氵母
月	月ＹＥ
加	加ＪＡ
金	金ＪＮ
目	目ＭＵ
特	牜土寸
跟	艮Ｇ
场	土Ｊ彳
林	林ＬＮ
由	由ＹＵ
万	丆Ｗ
美	大Ｍ
任	亻壬Ｒ
使	亻丈口
日	日ＲＩ
立	立ＬＩ
命	亼口卩
思	田心Ｓ
关	丷大Ｇ
百	丆日Ｂ
转	车二
理	王里Ｌ
常	尚巾Ｃ
血	丿皿Ｘ
乎	丿丷丁
受	受ＳＵ
离	文凵冂
该	讠亥Ｇ
界	田人刂
远	元辶Ｙ
平	干丷Ｐ
阵	阝车Ｚ
物	牜勹彳
冷	冫亽
数	米女攵
信	亻言Ｘ
刻	亥刂Ｋ
至	一厶土
突	穴大丶
失	失ＳＩ
怪	忄又土
随	阝辶
五	五ＷＵ
反	反ＦＮ
找	扌戈Ｚ
似	亻以Ｓ
许	讠午Ｘ
般	舟殳Ｂ
武	一弋止
雷	雨田Ｌ
非	非ＦＩ
奇	大可Ｑ
通	用辶
解	用牛
绝	纟巴
怕	忄白Ｐ
精	米青Ｊ
修	亻夂彡
暗	日立日
满	氵艹两
双	又又Ｓ
度	广廿又
且	且ＱＥ
红	纟工Ｈ
半	半ＢＮ
世	世ＳＩ
始	女厶口
倒	亻一刂
拉	扌立Ｌ
今	亽乛Ｊ
它	宀匕Ｔ
落	落各Ｌ
攻	工攵Ｇ
学	学子Ｘ
尔	小Ｅ
传	亻二
音	立日Ｙ
指	扌匕日
路	各Ｌ
越	走戈乚
表	ｒＢ
石	石ＳＩ
容	宀谷Ｒ
紧	刂又小
哥	可可Ｇ
合	亼口Ｈ
罗	罒夕Ｌ
利	禾刂Ｌ
冲	冫口丨
步	止少Ｂ
够	勹口夕
影	日小彡
姐	女且Ｊ
伤	亻力
若	艹口
亲	亲ＱＮ
功	工力Ｇ
整	木攵止
弟	丷弓丿
丝	丝丝一
息	丿目心
吃	口乙
众	人人人
花	艹亻匕
势	执力Ｓ
早	日十Ｚ
哈	口亼口
帝	旁巾Ｄ
流	氵充川
团	囗才Ｔ
青	青ＱＧ
根	木艮Ｇ
极	木及Ｊ
静	青亅
形	一廾彡
即	艮卩Ｊ
深	氵木
周	冂土口
近	斤辶Ｊ
千	千ＱＮ
消	氵冃
结	纟吉Ｊ
制	牛冂刂
干	干ＧＮ
帮	丰阝巾
速	木口辶
楚	林乛止
性	忄丿
备	夂田Ｂ
系	丿幺小
言	言ＹＮ
提	扌日止
教	耂子攵
皇	白王Ｈ
令	亽Ｌ
文	文ＷＮ
雪	雨彐Ｘ
谁	讠隹Ｓ
终	纟夂冫
必	心丿Ｂ
站	立占Ｚ
化	亻匕Ｈ
哪	口月阝
破	石皮Ｐ
认	讠人Ｒ
忙	忄亡Ｍ
往	彳主Ｗ
玉	王丶Ｙ
级	纟及Ｊ
车	车ＣＥ
底	广Ｃ七
总	丷口心
坐	人人土
巨	匚尸Ｊ
男	田力Ｎ
显	日业Ｘ
克	古儿Ｋ
各	各ＧＥ
新	亲斤Ｘ
斗	斗ＤＵ
仙	亻山Ｘ
急	彐心
切	七刀Ｑ
阳	阝日Ｙ
叶	口十Ｙ
领	亽页
收	丩攵Ｓ
衣	衣ＹＩ
敢	乛耳攵
异	巳廾Ｙ
围	囗二卩
达	大辶Ｄ
象	象ＸＧ
件	亻牛Ｊ
错	钅日
服	月卩又
慢	忄日又
保	亻口木
办	力八Ｂ
活	氵舌Ｈ
喜	吉首口
片	片ＰＮ
杨	木Ｊ彳
兴	兴八Ｘ
刀	刀ＤＯ
摇	扌爫缶
准	冫隹Ｚ
夜	亠亻夂
拿	亼口手
电	日乚Ｄ
交	亠父Ｊ
条	夂朩Ｔ
朝	十十月
华	亻匕十
管	宀官
断	米乚斤
兽	丷田口
决	冫夬Ｊ
尽	尺冫Ｊ
苦	艹古Ｋ
依	亻衣Ｙ
易	日勹彳
八	八ＢＡ
则	贝刂Ｚ
露	雨各
语	讠五口
兰	首二Ｌ
闪	门人Ｓ
冰	冫水Ｂ
足	足ＺＵ
记	讠己Ｊ
德	彳十心
响	口白口
害	宀丰口
及	及ＪＩ
球	王氺丶
阿	阝可Ａ
计	讠十Ｊ
顿	七凵页
爱	爱ＡＩ
告	告ＧＯ
夫	夫ＦＵ
七	七ＱＩ
嘴	口匕用
器	口口口
圣	又土Ｓ
南	Ｍ首十
留	Ｃ刀田
元	元ＹＮ
敌	舌攵Ｄ
沉	氵冖几
请	讠青Ｑ
官	宀官Ｇ
威	戊一女
每	母Ｍ
况	冫口儿
确	石用
答	亼口
乱	舌乚Ｌ
陈	阝七小
宝	宀王丶
视	礻见Ｓ
护	扌户Ｈ
格	木各Ｇ
脑	月文凵
兄	口儿Ｘ
狂	犭王Ｋ
淡	氵火火
识	讠口八
题	日止页
停	亻亮丁
司	一口
低	亻Ｃ七
雨	雨ＹＵ
呼	口丿丁
久	丶Ｊ
未	未ＷＩ
孩	子亥Ｈ
卫	卩一Ｗ
脚	月土卩
除	阝余Ｃ
古	古ＧＵ
亚	亚ＹＡ
字	宀子Ｚ
骑	马大可
房	户方Ｆ
代	代ＤＩ
伙	亻火Ｈ
鬼	白儿厶
员	口贝Ｙ
缓	纟爫又
复	日夂
六	亠八Ｌ
黄	由八
装	丬士衣
居	尸古Ｊ
凌	冫土夂
呵	口可Ｈ
米	米ＭＩ
恐	工几心
单	丷日十
旁	旁方Ｐ
钱	钅一戈
跑	包Ｐ
布	巾Ｂ
或	戈口一
爷	父卩Ｙ
玩	王元Ｗ
报	扌卩又
疑	匕矢止
术	木丶Ｓ
睛	目青Ｊ
隐	阝心
欢	又欠Ｈ
续	纟十头
章	章ＺＧ
差	工Ｃ
挥	扌冖车
父	父ＦＵ
句	勹口Ｊ
待	彳土寸
九	九ＪＵ
派	氵ｒ
持	扌土寸
类	米大Ｌ
宇	宀于Ｙ
丽	一冂冂
蓝	艹刂皿
佛	亻弓刂
刘	文刂Ｌ
忽	勹彳心
怀	忄不Ｈ
您	亻心
怒	女又心
掉	扌卜十
招	扌召Ｚ
希	乂巾
送	丷大辶
背	丬匕冃
工	工ＧＧ
甚	其乚Ｓ
烈	歹刂灬
卡	卜下Ｋ
细	纟田Ｘ
掌	尚手Ｚ
论	讠人匕
密	宀心山
运	云辶Ｙ
退	艮辶Ｔ
酒	氵酉Ｊ
求	氺丶Ｑ
猛	犭子皿
另	另ＬＧ
射	身寸Ｓ
集	隹木Ｊ
首	首丿目
北	丬匕Ｂ
照	日召灬
晚	日儿
赶	走干Ｇ
守	宀寸Ｓ
木	木ＭＵ
散	冃攵
穿	穴一才
联	耳丷大
铁	钅失Ｔ
段	Ｅ殳Ｄ
练	纟七小
喝	口日勹
需	雨丆皿
支	十又Ｚ
巴	巴ＢＡ
左	工Ｚ
陆	阝干凵
角	用Ｊ
书	乛卩丶
防	阝方Ｆ
忍	刀丶心
莫	莫ＭＯ
群	彐丿羊
民	巳七Ｍ
客	宀各Ｋ
线	纟一戈
毫	亮毛Ｈ
肯	止冃Ｋ
展	尸ｒ
谢	讠身寸
亮	亮几Ｌ
痛	疒用
股	月殳Ｇ
造	告辶Ｚ
妖	女丿大
虎	虍几Ｈ
秦	禾Ｑ
紫	止匕小
宫	宀口口
激	氵白攵
赵	走乂Ｚ
渐	氵车斤
震	雨厂ｒ
注	氵主Ｚ
禁	林示Ｊ
吸	口及Ｘ
取	耳又Ｑ
梦	林夕Ｍ
枪	木仓Ｑ
程	禾口王
叹	口又Ｔ
江	氵工Ｊ
简	门日
羽	羽ＹＵ
友	又Ｙ
继	纟米乚
念	亽乛心
右	口Ｙ
萧	艹彐川
热	执灬Ｒ
份	亻分Ｆ
乐	Ｃ小Ｌ
压	厂土丶
既	艮旡Ｊ
靠	告非Ｋ
香	禾日Ｘ
恶	亚心Ｅ
引	弓丨Ｙ
止	止ＺＩ
包	包ＢＯ
追	追辶Ｚ
仅	亻又Ｊ
寒	宀井冫
雅	一才隹
争	彐亅
愿	厂白心
超	走召Ｃ
狠	犭艮Ｈ
厉	厂丆
式	弋工Ｓ
波	氵皮Ｂ
刺	木冂刂
号	口丂Ｈ
态	大丶心
存	Ｐ子Ｃ
游	氵族子
台	厶口Ｔ
跳	ＫＫ
狼	犭丶艮
属	尸丿冂
妹	女未Ｍ
炼	火七小
灭	一火Ｍ
英	艹央Ｙ
醒	酉日
举	兴八干
嘿	口黑Ｈ
境	土竟Ｊ
胜	月丿
诉	讠斤丶
抱	扌包Ｂ
毕	比十Ｂ
务	夂力Ｗ
甲	甲ＪＡ
齐	文刂Ｑ
拍	扌白Ｐ
唐	广彐口
君	彐丿口
楼	木米女
险	阝亼兴
院	阝宀元
建	彐干廴
观	又见Ｇ
柔	才木
逃	ＫＫ辶
置	罒十且
娘	女丶艮
担	扌日一
殿	尸殳
阴	阝月Ｙ
呆	口木Ｄ
层	尸云Ｃ
试	讠弋工
约	纟勹丶
凡	几丶Ｆ
眉	尸目Ｍ
弹	弓丷十
救	氺丶攵
银	钅艮Ｙ
统	纟充儿
否	不口Ｆ
索	十冖小
抓	扌爪Ｚ
府	广亻寸
调	讠冂土
曾	丷日日
魂	云白儿
基	其土Ｊ
顶	丁页Ｄ
峰	山夂丰
苏	艹力八
图	囗夂冫
松	木八厶
议	讠丶乂
料	米斗Ｌ
顾	厂页
严	亚丿Ｙ
业	业ＹＥ
恩	囗大心
礼	礻乚Ｌ
耳	耳ＥＲ
选	儿辶
余	余ＹＵ
败	贝攵Ｂ
区	匚乂Ｑ
顺	川页Ｓ
皮	皮ＰＩ
沙	氵少Ｓ
瞬	目爫舛
树	木又寸
秘	禾心丿
商	商ＳＧ
组	纟且Ｚ
块	土夬Ｋ
汉	氵又Ｈ
充	充儿Ｃ
贵	贵ＧＩ
迷	米辶Ｍ
混	氵日比
纷	纟分Ｆ
示	示ＳＩ
伸	亻日丨
娜	女月阝
助	且力Ｚ
呀	口一才
封	圭寸Ｆ
排	扌非Ｐ
期	其月Ｑ
肉	内人Ｒ
船	舟几口
座	广人土
义	丶乂Ｙ
舰	舟见Ｊ
闻	门耳Ｗ
升	丿廾Ｓ
室	宀一土
妈	女马Ｍ
亡	亡ＷＧ
付	亻寸Ｆ
控	扌穴工
警	艹攵言
负	负ＦＵ
推	扌隹Ｔ
扬	扌Ｊ彳
模	木莫Ｍ
芒	艹亡Ｍ
凤	几又Ｆ
虚	虍业Ｘ
默	黑大丶
土	土ＴＵ
技	扌十又
费	弓刂贝
温	氵日皿
市	亠巾Ｓ
麻	广林Ｍ
初	衤刀Ｃ
考	耂丂Ｋ
拥	扌用Ｙ
究	穴九Ｊ
握	扌尸土
资	冫欠贝
普	首业日
翻	丿田羽
察	宀祭示
独	犭虫Ｄ
幸	土首十
舞	夕舛
称	禾小
玄	玄ＸＮ
母	母ＭＵ
暴	日氺
按	扌安Ａ
孙	子小Ｓ
睡	目千垂
改	己攵Ｇ
换	扌大
素	幺小
较	车亠父
具	且八Ｊ
箭	首前
品	口口口
忘	亡心Ｗ
状	丬大丶
堂	尚土Ｔ
副	畐刂Ｆ
承	乛水三
野	里丁
锋	钅夂丰
洞	氵冂一
遇	甲冂辶
查	木日一
洛	氵各Ｌ
局	尸口
赛	宀井贝
划	戈刂Ｈ
权	木又Ｑ
藏	艹戊丆
味	口未Ｗ
丹	冂亠Ｄ
故	古攵Ｇ
钟	钅口丨
坏	土不Ｈ
仍	亻乃Ｒ
宗	宀示Ｚ
弱	弓冫弓
弄	王廾Ｎ
脱	月丷儿
菲	艹非Ｆ
胸	月勹乂
哼	口高亅
药	艹纟勹
历	厂力Ｌ
徐	彳余Ｘ
拳	手Ｑ
爆	火日氺
杰	木灬Ｊ
谈	讠火火
须	彡页Ｘ
坚	刂又土
奥	白米大
仿	亻方Ｆ
据	扌尸古
偷	亻亼前
施	族也Ｓ
产	立丿Ｃ
营	营口口
骨	骨ＧＵ
晶	日日日
透	禾乃辶
尊	酋寸Ｚ
短	矢一首
抬	扌厶口
政	一止攵
烦	火页Ｆ
河	氵可Ｈ
牙	一才Ｙ
维	纟隹Ｗ
证	讠一止
卷	Ｊ
幽	山幺幺
草	艹日十
森	木林Ｓ
吴	口一大
摆	扌罒厶
蒙	营二豕
危	厂
毒	母Ｄ
投	扌殳Ｔ
熟	高九灬
飘	覀示风
导	巳寸Ｄ
朋	月月Ｐ
质	十贝
释	丿米干
喊	口戊一
胡	古月Ｈ
参	厶大彡
休	亻木Ｘ
劲	又工力
景	日高小
挡	扌彐
印	Ｅ卩Ｙ
惜	忄日
枫	木风Ｆ
幻	幺Ｈ
欲	谷欠Ｙ
摸	扌莫Ｍ
烟	火囗大
致	一土攵
州	州ＺＵ
冥	冖日八
尼	尸匕Ｎ
抗	扌亠几
妙	女少Ｍ
翼	羽田八
秋	禾火Ｑ
凝	冫止
寻	彐寸Ｘ
盘	舟皿Ｐ
永	丶水Ｙ
板	木反Ｂ
智	矢口日
哦	口手戈
责	贝Ｚ
尸	尸ＳＩ
傲	亻敖Ａ
柳	木Ｇ卩
御	彳卩
临	刂日
浪	氵丶艮
辈	非车Ｂ
娇	女丿刂
恨	忄艮Ｈ
吓	口下Ｘ
价	亻人刂
硬	石丈日
探	扌木
际	阝示Ｊ
横	木八
标	木示Ｂ
纳	纟内Ｎ
欧	匚乂欠
宁	宁ＮＧ
墙	土十囗
田	田ＴＮ
习	习ＸＩ
肩	户冃Ｊ
戏	又戈Ｘ
奈	大示Ｎ
设	讠殳Ｓ
效	亠父攵
福	礻畐Ｆ
袋	代衣Ｄ
移	禾夕夕
型	一刂土
疯	疒风Ｆ
毛	毛ＭＯ
贝	贝ＢＩ
冒	日目Ｍ
叔	卜小又
碎	石亠十
轰	车又又
扑	扌卜Ｐ
奋	大田Ｆ
饭	饣反Ｆ
科	禾斗Ｋ
惨	忄厶彡
咱	口丿目
治	氵厶口
湖	氵古月
环	王不Ｈ
尘	小土Ｃ
略	田各Ｌ
躲	身几木
免	口儿
盟	日月皿
珠	王朱Ｚ
迎	Ｃ卩辶
凭	亻壬几
规	夫见Ｇ
犹	犭尢丶
雄	厶隹
距	匚尸
伯	亻白Ｂ
借	亻日
域	土戈口
床	广木Ｃ
骂	口口马
莉	艹禾刂
朱	朱ＺＵ
史	口乂Ｓ
避	尸辛辶
聚	耳又乑
皱	彐皮
秀	禾乃Ｘ
韩	十十卩
挑	扌ＫＫ
降	阝夂舛
敬	艹口攵
源	氵厂小
徒	彳走Ｔ
束	木口Ｓ
鲜	鱼羊Ｘ
撞	扌立里
岁	山夕Ｓ
架	加木Ｊ
嘛	口广林
哭	口口大
袭	龙衣Ｘ
惑	戈口心
罪	罒非Ｚ
节	艹卩Ｊ
罢	罒土厶
食	食ＳＩ
啦	口扌立
唯	口隹Ｗ
买	乛头Ｍ
训	讠川Ｘ
腿	月艮辶
稍	禾冃
校	木亠父
艾	艹乂Ａ
诺	讠艹口
某	廿一木
邪	一才阝
鲁	鱼日Ｌ
姑	女古Ｇ
阻	阝且Ｚ
丁	丁ＤＧ
塔	土艹口
闭	门才Ｂ
迅	乙十辶
逸	兔辶Ｙ
臣	匚丨尸
残	歹一戈
裂	歹刂衣
托	扌丿七
良	丶艮Ｌ
泪	氵目Ｌ
尖	小大Ｊ
晓	日戈儿
伊	亻彐丿
洋	氵羊Ｙ
屋	尸一土
尚	尚ＳＧ
颗	日木页
鱼	鱼ＹＵ
炸	火乍Ｚ
仇	亻九Ｃ
讲	讠井Ｊ
焰	火臼
配	酉己Ｐ
旧	丨日Ｊ
绿	纟彐水
假	亻尸又
圆	囗口贝
验	马亼兴
番	丿米田
搞	扌高Ｇ
迹	亦辶Ｊ
荡	落Ｊ彳
彩	爫木彡
腾	月马
恢	忄火
腰	月覀女
厅	厂丁Ｔ
牛	牛ＮＵ
吼	口子乚
占	占ＺＮ
颤	亠一页
趣	走耳又
梅	木母
奔	大十廾
臂	尸辛冃
愣	忄罒方
勇	用力
套	大Ｅ厶
剩	禾丬刂
志	士心Ｚ
舒	亼古丁
端	立山皿
虑	虍心Ｌ
医	匚矢Ｙ
妮	女尸匕
炮	火包Ｐ
蛋	乛止虫
卖	十乛头
闹	门亠巾
颜	立丿页
归	刂彐Ｇ
圈	囗
限	阝艮Ｘ
浮	氵爫子
弃	充廾Ｑ
适	舌辶Ｓ
软	车欠Ｒ
抵	扌Ｃ七
厚	厂日子
帅	刂巾Ｓ
尤	尢丶Ｙ
讶	讠一才
广	广ＧＧ
范	落Ｆ
桌	卜日木
欣	斤欠Ｘ
病	疒一内
共	八Ｇ
职	耳口八
诸	讠者Ｚ
镇	钅十八
专	二Ｚ
值	亻十且
偏	亻户冊
杂	九朩Ｚ
增	土丷日
豪	亮豕Ｈ
咬	口亠父
触	用虫
陷	阝臼
雾	雨夂力
挺	扌壬廴
炎	火火Ｙ
稳	禾心
择	扌又干
巧	工丂Ｑ
胖	月半Ｐ
附	阝亻寸
盯	目丁Ｄ
碰	石首业
纪	纟己Ｊ
阶	阝人刂
谷	谷ＧＵ
嗯	口囗心
岛	鸟山Ｄ
夏	丆目夂
扫	扌彐Ｓ
潜	氵夫日
毁	臼工殳
项	工页Ｘ
旋	族乛止
抢	扌仓Ｑ
抽	扌由Ｃ
优	亻尢丶
迪	由辶Ｄ
涌	氵用
网	冂乂乂
祖	礻且Ｚ
拜	一丰
测	氵贝刂
伟	亻二卩
案	安木Ａ
列	歹刂Ｌ
谓	讠田冃
操	扌口木
春	日Ｃ
店	广占Ｄ
瑞	王山皿
善	羊首口
逼	畐辶Ｂ
浑	氵冖车
输	车亼前
烧	火戈儿
瞪	目癶首
慕	莫Ｍ
懂	忄艹里
富	宀畐Ｆ
汗	氵干Ｈ
侧	亻贝刂
赤	土亦Ｃ
率	亠幺十
杯	木不Ｂ
京	高小Ｊ
吉	吉ＪＩ
滚	氵衣八
曼	日罒又
浩	氵告Ｈ
获	艹犭大
轮	车人匕
损	扌口贝
抖	扌斗Ｄ
累	田幺小
讨	讠寸Ｔ
苍	艹仓Ｃ
悄	忄冃
养	丶刂
塞	宀井土
鸣	口鸟Ｍ
挂	扌圭Ｇ
胆	月日一
孤	子瓜Ｇ
傻	亻白夂
陪	阝立口
镜	钅竟Ｊ
凶	乂凵Ｘ
吐	口土Ｔ
杜	木土Ｄ
猜	犭青Ｃ
庞	广龙Ｐ
幕	莫巾Ｍ
琳	王林Ｌ
蛇	虫宀匕
拼	扌首廾
孔	子乚Ｋ
盖	皿Ｇ
材	木才Ｃ
扎	扌乚Ｚ
爸	父巴Ｂ
预	丁页
晃	日儿
闷	门心Ｍ
姓	女丿
莱	艹未丷
仔	亻子Ｚ
吟	口亽乛
遍	户冊辶
彻	彳七刀
纯	纟七凵
伦	亻人匕
盗	冫欠皿
愤	忄十贝
困	囗木Ｋ
缘	纟彑豕
纵	纟人人
啸	口彐川
夺	大寸Ｄ
壁	尸辛土
宋	宀木Ｓ
估	亻古Ｇ
介	人刂Ｊ
画	一田凵
庄	广土Ｚ
狗	犭勹口
沈	氵巾乚
贼	贝戈
补	衤卜Ｂ
摩	广林手
脉	月丶水
泰	氺Ｔ
痕	疒艮Ｈ
燕	廿口灬
折	扌斤Ｚ
劫	土厶力
演	氵穴一
灰	火Ｈ
伏	亻大丶
悠	亻攵心
婆	氵皮女
创	仓刂Ｃ
研	石一廾
含	亽乛口
写	冖与Ｘ
凯	山己几
岳	丘山Ｙ
午	午ＷＵ
池	氵也Ｃ
睁	目亅
萨	艹阝丿
暂	车斤日
闲	门木Ｘ
概	木艮旡
逐	豕辶Ｚ
旦	日一Ｄ
登	癶一首
误	讠口大
戒	戈廾Ｊ
村	木寸Ｃ
街	彳圭亍
跃	丿大
牌	片卑Ｐ
廷	壬廴Ｔ
罩	罒卜十
斩	车斤Ｚ
班	王刂王
爵	爫艮寸
陛	阝比土
膀	月旁方
迟	尺辶Ｃ
踪	宀示
替	夫夫日
谋	讠廿木
伴	亻半Ｂ
霸	雨革月
傅	亻甫寸
怜	忄亽
乌	乌ＷＵ
曲	日刂Ｑ
瞧	目焦Ｑ
惧	忄且八
俊	亻厶夂
歌	可可欠
咒	口口几
漂	氵覀示
嘻	口吉口
倍	亻立口
采	爫木Ｃ
昨	日乍Ｚ
互	一彑Ｈ
鹰	广亻鸟
蒂	艹旁巾
舍	亼古Ｓ
慌	忄艹川
糊	米古月
犯	犭Ｆ
扭	扌丑Ｎ
判	半刂Ｐ
丢	千一厶
羞	丑Ｘ
昏	Ｃ七日
竹	竹ＺＵ
唤	口大
忧	忄尢丶
锐	钅丷儿
琴	王王乛
宽	宀艹见
莲	艹车辶
躯	身匚乂
郎	丶艮阝
疼	疒夂冫
席	广廿巾
伍	亻五Ｗ
剧	尸古刂
碧	王白石
征	彳一止
鸟	鸟ＮＯ
赞	贝
丈	丈ＺＧ
侍	亻土寸
悉	丿米心
漫	氵日又
缩	纟宀日
帐	巾长Ｚ
遭	西日辶
坦	土日一
喃	口Ｍ首
悟	忄五口
壮	丬士Ｚ
辰	厂ｒＣ
貌	豸白儿
鼻	丿目丌
聊	耳Ｇ卩
怨	夕心
弓	弓ＧＧ
绕	纟戈儿
私	禾厶Ｓ
耀	儿隹
财	贝才Ｃ
掩	扌大乚
吞	一大口
织	纟口八
监	刂皿
洗	氵儿
佩	亻几一
融	一冂虫
插	扌千臼
梁	氵刀木
忠	口丨心
悲	非心Ｂ
笔	毛Ｂ
迫	白辶Ｐ
凉	冫高小
丫	丷丨Ｙ
鼓	吉首又
豫	丁象
亦	亦ＹＩ
敏	母攵
狱	犭大丶
召	召ＺＯ
佣	亻用Ｙ
忆	忄乙Ｙ
朵	几木Ｄ
博	十甫寸
狐	犭瓜Ｈ
吹	口欠Ｃ
拔	扌犮Ｂ
荣	营木Ｒ
劳	营力Ｌ
茶	艹人朩
缠	纟广里
盛	戊皿
磨	广林石
浓	氵巾ｒ
净	冫亅
仰	亻Ｃ卩
遥	爫缶辶
废	广发Ｆ
恭	八
菜	艹爫木
阁	门各Ｇ
缺	缶夬Ｑ
粗	米且Ｃ
躺	身尚Ｔ
宣	宀一一
桑	又又木
绍	纟召Ｓ
惯	忄毌贝
遗	贵辶Ｙ
晕	日冖车
执	执ＺＩ
喷	口十贝
刹	乂朩刂
努	女又力
脆	月
轩	车干Ｘ
佳	亻圭Ｊ
耗	耒毛Ｈ
窗	穴白夂
积	禾口八
策	木冂
辉	儿车
灯	火丁Ｄ
辛	辛ＸＮ
援	扌爫又
堆	土隹Ｄ
扶	扌夫Ｆ
踏	水日
库	广车Ｋ
屁	尸比Ｐ
唇	厂ｒ口
奴	女又Ｎ
翔	羽Ｘ
熊	厶匕灬
粉	米分Ｆ
勒	革力Ｌ
尾	尸毛Ｗ
批	扌比Ｐ
乖	千丬匕
艳	丰巴
趁	走人彡
慧	丰丰心
姬	女匚丨
爬	爪巴Ｐ
隆	阝夂
怖	忄巾
赏	尚贝Ｓ
晨	日厂ｒ
刃	刀丶Ｒ
媚	女尸目
耐	丆皿寸
拖	扌也
丰	丰ＦＧ
码	石马Ｍ
诚	讠戊
律	彳彐干
乃	乃ＮＩ
赫	土亦亦
曹	西日Ｃ
岂	山己Ｑ
固	囗古Ｇ
洁	氵吉Ｊ
盾	十目
社	礻土Ｓ
郭	高子阝
骗	马户冊
滑	氵骨Ｈ
霄	雨冃
隔	阝一冂
纸	纟Ｃ七
戴	十戈八
额	宀各页
惹	艹心
撤	扌充攵
荒	艹亡川
季	禾子Ｊ
延	丿止廴
痴	疒矢口
锁	钅贝
旗	族其Ｑ
撒	扌攵
郁	冃阝
典	冂八
颇	皮页Ｐ
侯	亻尸矢
园	囗元Ｙ
振	扌厂ｒ
仪	亻丶乂
省	少目Ｓ
猎	犭日
殊	歹朱Ｓ
绪	纟者Ｘ
跪	
玛	王马Ｍ
抚	扌干乚
油	氵由Ｙ
委	禾女Ｗ
纹	纟文Ｗ
泉	白水Ｑ
滴	氵啇Ｄ
洪	氵八
启	户口Ｑ
供	亻八
忌	己心Ｊ
拦	扌首二
祭	祭示Ｊ
妻	十彐女
贴	贝占Ｔ
妇	女彐Ｆ
庆	广大Ｑ
擦	扌宀示
币	丿巾Ｂ
婚	女Ｃ日
牢	宀牛Ｌ
仁	亻二Ｒ
甘	廿一Ｇ
奶	女乃Ｎ
径	彳又工
倾	亻匕页
符	亻寸
赌	贝者Ｄ
钻	钅占Ｚ
蛮	亦虫Ｍ
矮	矢禾女
唉	口厶矢
堡	亻口土
馆	饣宀官
宜	宀且Ｙ
姿	冫欠女
爽	大乂乂
堪	土其乚
焦	焦ＪＯ
劈	尸辛刀
零	雨亽
薄	落甫寸
扰	扌尢丶
艘	舟叟Ｓ
耶	耳阝Ｙ
牧	牜攵Ｍ
益	首八皿
朗	丶艮月
挣	扌亅
递	丷弓辶
匆	勹彳丶
肖	冃Ｘ
婷	女亮丁
亏	二ＳＫ
袍	衤包Ｐ
燃	火丶灬
扯	扌止Ｃ
叛	半反Ｐ
胁	月力八
拒	扌匚尸
肚	月土Ｄ
皆	比白Ｊ
柱	木主Ｚ
墨	黑土Ｍ
董	艹千里
砸	石匚巾
莎	落少Ｓ
液	氵亠夂
辆	车两Ｌ
途	余辶Ｔ
岩	山石Ｙ
芳	艹方Ｆ
慰	尸寸心
户	户ＨＵ
烂	火首二
欺	其欠Ｑ
针	钅十Ｚ
砍	石欠Ｋ
筑	工几
醉	酉亠十
扔	扌乃Ｒ
洲	氵州Ｚ
协	十力八
驾	加马Ｊ
享	高子Ｘ
漠	氵莫Ｍ
巫	工人人
莹	营王丶
撑	扌尚手
郑	丷大阝
眨	目丿之
赢	赢贝Ｙ
恼	忄文凵
珍	王人彡
虫	虫ＣＧ
康	广彐水
椅	木大可
俩	亻两Ｌ
旅	族丿ｒ
货	亻匕贝
减	冫戊一
尝	云Ｃ
盈	乃又皿
愧	忄白儿
邦	丰阝Ｂ
骇	马亥Ｈ
餐	卜又食
埋	土里Ｍ
瑟	王心丿
抛	扌九力
吻	口勹彳
敲	高卜又
猫	犭艹田
侵	亻彐又
弯	亦弓Ｗ
茫	落亡Ｍ
悔	忄母
喘	口山皿
穴	穴ＸＥ
玲	王亽
勾	勹厶Ｇ
哎	口艹乂
截	十戈隹
舌	舌ＳＥ
肃	彐川Ｓ
牵	大冖牛
例	亻歹刂
庭	广壬廴
彼	彳皮Ｂ
宙	宀由Ｚ
氏	Ｃ七Ｓ
夹	夫丷Ｊ
霜	雨木目
仗	亻丈Ｚ
济	氵文刂
吕	口口Ｌ
渊	氵刂米
卓	卜日十
甜	舌廿一
笼	龙Ｌ
柄	木一内
嘉	吉首加
诡	讠
姆	女母Ｍ
脖	月十子
爹	父夕夕
霍	雨隹Ｈ
抹	扌末Ｍ
艺	艹乙Ｙ
倩	亻青Ｑ
秒	禾少Ｍ
昂	日Ｃ卩
踢	日勹
哀	衣口Ａ
末	末ＭＯ
奉	干Ｆ
劝	又力Ｑ
腹	月夂
钢	钅冂乂
宏	宀厶
爪	爪ＺＡ
挤	扌文刂
泽	氵又干
鸿	氵工鸟
核	木亥Ｈ
侠	亻夫丷
猪	犭者Ｚ
疾	疒矢Ｊ
瓶	首廾瓦
僵	亻一一
乘	禾丬匕
寂	宀小又
粮	米丶艮
聪	耳丷心
诱	讠禾乃
懒	忄木负
搭	扌艹口
潮	氵十月
鹏	月月鸟
魏	禾女儿
咐	口亻寸
鸡	又鸟Ｊ
肤	月夫Ｆ
薇	艹微几
弥	弓小
瓦	瓦ＷＡ
央	央ＹＧ
勉	儿力
川	川ＣＮ
屈	尸出Ｑ
耸	人人耳
匹	匚儿Ｐ
尺	尺ＣＩ
喂	口田ｒ
丧	十首ｒ
悍	忄日干
悬	且厶心
拾	扌亼口
晴	日青Ｑ
亿	亻乙Ｙ
讯	讠乙十
溜	氵刀田
魄	白白儿
帕	巾白Ｐ
括	扌舌Ｋ
孟	子皿Ｍ
乔	丿大刂
怔	忄一止
蕾	艹雨田
搜	扌叟Ｓ
诗	讠土寸
偶	亻甲冂
均	土勹冫
童	立里Ｔ
覆	覀彳夂
厌	厂大丶
悦	忄丷儿
载	十戈车
掠	扌高小
垂	千垂Ｃ
琪	王其Ｑ
泄	氵世Ｘ
霞	雨丨又
港	氵巳
袁	土口ｒ
臭	丿目大
衡	彳亍
构	木勹厶
肌	月几Ｊ
词	讠一
纤	纟千Ｘ
票	覀示Ｐ
诀	讠夬Ｊ
饰	饣巾
噬	口工
宠	宀龙Ｃ
脏	月广土
袖	衤由Ｘ
键	钅彐廴
穷	穴力Ｑ
泥	氵尸匕
驻	马主Ｚ
眸	目厶牛
航	舟亠几
辞	舌辛Ｃ
乡	丝丿Ｘ
催	亻山隹
宿	宀亻日
慎	忄十八
魅	白儿未
撕	扌其斤
逆	丷山辶
凑	冫大
缝	纟夂辶
歉	首兼欠
授	扌受Ｓ
甩	月乚Ｓ
映	日央Ｙ
岸	山厂干
凰	几白王
唱	口日日
奸	女干Ｊ
陵	阝土夂
崇	山宀示
枚	木攵Ｍ
读	讠十头
暖	日爫又
扩	扌广Ｋ
狮	犭一巾
瑶	王爫缶
沿	氵几口
渡	氵广又
稀	禾乂巾
搂	扌米女
恋	亦心Ｌ
捏	扌日土
饶	饣戈儿
吩	口分Ｆ
笨	木一
返	反辶Ｆ
赖	木口负
斥	斤丶Ｃ
贤	刂又贝
煞	攵灬
询	讠勹日
斜	余斗Ｘ
撼	扌戊心
眯	目米Ｍ
铺	钅甫Ｐ
咳	口亥Ｋ
浅	氵一戈
尬	尢人刂
尴	尢刂
齿	止人凵
洒	氵西Ｓ
督	卜又目
奖	丬夕大
卑	卑ＢＩ
染	氵九木
促	亻足Ｃ
弗	弓刂Ｆ
娅	女亚Ｙ
麽	广林厶
泛	氵丿之
契	丰刀大
酷	酉告Ｋ
罚	罒讠刂
络	纟各Ｌ
埃	土厶矢
课	讠日木
屠	尸者Ｔ
祸	礻口内
汇	氵匚Ｈ
疗	疒乛亅
赐	贝日勹
刑	一廾刂
夸	大二Ｓ
雕	冂土隹
检	木亼兴
祥	礻羊Ｘ
俗	亻谷Ｓ
俱	亻且八
摔	扌亠十
屏	尸首廾
麦	夂Ｍ
闯	门马Ｃ
予	丁Ｙ
矿	石广Ｋ
恒	忄一一
郡	彐丿阝
呜	口乌Ｗ
疲	疒皮Ｐ
迈	丆辶
寸	寸ＣＮ
详	讠羊Ｘ
亭	亮丁Ｔ
巡	巛辶Ｘ
滋	氵首幺
葛	艹勹乚
婴	贝贝女
录	彐水Ｌ
涛	氵丰寸
冠	冖元寸
枝	木十又
翅	十又羽
窜	穴口丨
昆	日比Ｋ
婉	女宀
妃	女己Ｆ
矛	才Ｍ
蝶	虫世木
瘦	疒叟Ｓ
编	纟户冊
俏	亻冃
贪	亽乛贝
繁	攵小
绵	纟白巾
棋	木其Ｑ
斧	父斤Ｆ
裹	衣日木
姜	女Ｊ
氛	气分Ｆ
後	彳幺夂
乾	十十乙
拨	扌发Ｂ
慈	首幺心
瞒	目艹两
嫣	女一Ｓ
咕	口古Ｇ
屑	尸冃
铃	钅亽
辱	厂ｒ寸
雀	小隹Ｑ
冯	冫马Ｆ
允	厶儿Ｙ
樱	木贝女
愈	亼前心
宾	穴丘Ｂ
晰	日木斤
掏	扌勹缶
措	扌日
啪	口扌白
誓	扌斤言
农	巾ｒＮ
糟	米西日
驶	马口乂
捉	扌足Ｚ
祝	礻口儿
朕	月丷大
咯	口各Ｋ
扮	扌分Ｂ
淫	氵爫壬
鼠	臼鼠Ｓ
畏	田ｒＷ
羊	羊ＹＧ
驱	马匚乂
恰	忄亼口
璃	王文冂
芙	艹夫Ｆ
烁	火Ｃ小
岚	山风Ｌ
梯	木丷弓
裁	十戈衣
韵	立日勹
咽	口囗大
辕	车土ｒ
夕	夕ＸＩ
涯	氵厂圭
卢	卜尸Ｌ
碍	石日寸
幅	巾畐Ｆ
扇	户羽Ｓ
愕	忄口Ｓ
芸	艹云Ｙ
哇	口圭Ｗ
润	氵门王
崩	山月月
县	且厶Ｘ
杖	木丈Ｚ
汤	氵Ｊ彳
翠	羽亠十
健	亻彐廴
箱	木目
恍	忄儿
骷	骨古Ｋ
捕	扌甫Ｂ
育	充冃Ｙ
猴	犭尸矢
遮	广廿辶
泡	氵包Ｐ
麟	鹿米舛
扣	扌口Ｋ
鼎	目爿片
溃	氵贵Ｋ
娃	女圭Ｗ
髅	骨米女
逍	冃辶
述	木丶辶
豹	豸勹丶
评	讠干丷
献	Ｍ大丶
涂	氵余Ｔ
序	广丁
铜	钅冂一
饮	饣欠Ｙ
灾	宀火Ｚ
湿	氵日业
冬	夂冫Ｄ
贫	分贝Ｐ
汹	氵乂凵
党	尚儿Ｄ
棒	木干
贯	毌贝Ｇ
串	口口丨
丛	人人一
昌	日日Ｃ
棍	木日比
嫁	女宀豕
弘	弓厶Ｈ
肥	月巴Ｆ
穆	禾白彡
挖	扌穴乙
阔	门氵舌
跌	失Ｄ
丑	丑ＣＵ
赚	贝首兼
披	扌皮Ｐ
漆	氵木氺
奏	一大
贺	加贝Ｈ
喉	口尸矢
酸	酉厶夂
捷	扌一止
卧	匚丨卜
凄	冫十女
割	宀口刂
违	二卩辶
役	彳殳Ｙ
坛	土云Ｔ
砰	石干丷
筋	月力
裸	衤日木
井	井ＪＧ
涨	氵弓长
沐	氵木Ｍ
仓	仓ＣＧ
巍	山女儿
宴	宀日女
饿	饣手戈
鞭	革亻丈
馨	声殳日
瓜	瓜ＧＡ
骚	马又虫
匪	匚非Ｆ
耻	耳止Ｃ
妄	亡女Ｗ
肆	Ｅ厶干
宛	宀夕
裤	衤广车
蠢	虫虫
龟	日乚
妥	爫女Ｔ
霆	雨壬廴
雯	雨文Ｗ
吵	口少Ｃ
驰	马也Ｃ
嫩	女木攵
审	宀日丨
戈	戈ＧＥ
款	士示欠
桥	木丿刂
诧	讠宀七
晌	日白口
勃	十子力
搬	扌舟殳
仆	亻卜Ｐ
漏	氵尸雨
械	木戈廾
彭	吉首彡
盔	火皿
灌	氵艹隹
桃	木ＫＫ
黛	代黑Ｄ
黎	禾勹氺
饱	饣包Ｂ
欠	欠ＱＮ
抑	扌Ｃ卩
疆	弓土一
嘶	口其斤
辣	辛木口
纠	纟丩Ｊ
签	亼兴
购	贝勹厶
镖	钅覀示
揉	扌木
愚	甲冂心
勤	廿力
誉	兴八言
鄙	口囗阝
衫	衤彡Ｓ
珊	王册Ｓ
弩	女又弓
呈	口王Ｃ
腕	月宀
怡	忄厶口
坠	阝人土
腥	月日
培	土立口
牲	牜丿
窝	穴口内
障	阝章Ｚ
锦	钅白巾
蓉	萱谷Ｒ
拢	扌龙Ｌ
瞳	目立里
麒	鹿比其
析	木斤Ｘ
脾	月卑Ｐ
涩	氵刀止
蓦	莫马Ｍ
铠	钅山己
嘲	口十月
毅	立豕殳
僧	亻丷日
尉	尸示寸
寺	土寸Ｓ
链	钅车辶
邀	白攵辶
企	人止Ｑ
蜜	宀心虫
骤	马又乑
趴	八Ｐ
频	止少页
挨	扌厶矢
蒋	艹丬寸
卿	Ｇ艮卩
植	木十且
刷	尸巾刂
厂	厂ＣＧ
歪	不一止
嚣	口口口
琼	王高小
耍	丆皿女
龄	止凵
拟	扌以Ｎ
崖	山厂圭
寨	宀井朩
伐	亻戈Ｆ
丘	丘ＱＵ
柯	木可Ｋ
磊	石石石
晋	亚日Ｊ
艰	又艮Ｊ
竞	立口儿
碗	石宀
慨	忄艮旡
涉	氵止少
艇	舟壬廴
谨	讠廿
荷	艹亻可
跨	大Ｓ
浴	氵谷Ｙ
舱	舟仓Ｃ
颠	十八页
趟	走尚Ｔ
盒	亼口皿
撇	扌丷攵
骄	马丿刂
逊	子小辶
坑	土亠几
柜	木匚尸
摧	扌山隹
崔	山隹Ｃ
幼	幺力Ｙ
愁	禾火心
仑	人匕Ｌ
姨	女大弓
踩	爫木
谅	讠高小
坤	土日丨
绑	纟丰阝
锤	钅千垂
哑	口亚Ｙ
贾	覀贝Ｊ
宰	宀辛Ｚ
乳	爫子乚
陌	阝丆日
惠	士日心
竖	刂又立
销	钅冃
叮	口丁Ｄ
访	讠方Ｆ
虹	虫工Ｈ
绽	纟宀止
沾	氵占Ｚ
添	氵一
沃	氵丿大
挽	扌儿
迦	加辶Ｊ
舟	舟ＺＵ
堵	土者Ｄ
鹿	鹿比Ｌ
纱	纟少Ｓ
巾	巾ＪＮ
荆	艹廾刂
薛	艹追辛
绩	纟贝
捂	扌五口
枯	木古Ｋ
腐	广亻内
兔	兔ＴＵ
凛	冫亠示
夷	大弓Ｙ
梵	林几丶
哗	口匕十
绳	纟口乚
靖	立青Ｊ
搏	扌甫寸
斌	文一弋
颈	又工页
筹	丰寸
逝	扌斤辶
厨	厂一寸
辅	车甫Ｆ
逗	一口辶
藤	艹月氺
盼	目分Ｐ
咦	口大弓
尹	彐丿Ｙ
呃	口厂
芬	艹分Ｆ
狸	犭里Ｌ
矩	矢匚尸
憾	忄戊心
膝	月木氺
雁	厂亻隹
胳	月各Ｇ
咧	口歹刂
沌	氵七凵
於	方人冫
墓	莫土Ｍ
畅	日丨Ｊ
擅	扌亠一
冻	冫七小
摊	扌又隹
黯	黑立日
泣	氵立Ｑ
楞	木罒方
叉	又丶Ｃ
籍	耒日
牺	牜西Ｘ
敖	敖ＡＯ
哄	口八
铭	钅夕口
霉	雨母
躬	身弓Ｇ
淋	氵林Ｌ
膊	月甫寸
嫌	女首兼
歇	日乚欠
捧	扌干
痒	疒羊Ｙ
塌	土日羽
嚷	口衣口
涵	氵乛凵
旨	匕日Ｚ
灿	火山Ｃ
摄	扌耳又
削	冃刂
茵	艹囗大
嘟	口者阝
匕	匕ＢＩ
膛	月尚土
拱	扌八
肢	月十又
眠	目巳七
珑	王龙Ｌ
伪	亻冫力
斤	斤ＪＮ
逛	犭王辶
惶	忄白王
励	厂丆力
儒	亻雨皿
陡	阝走Ｄ
仲	亻口丨
瞄	目艹田
哨	口冃
羡	冫欠
掀	扌斤欠
辽	乛亅辶
沟	氵勹厶
墅	里土
汽	氵气Ｑ
档	木彐
隶	彐水Ｌ
描	扌艹田
俘	亻爫子
蜂	虫夂丰
呐	口内Ｎ
哲	扌斤口
卒	亠人十
赔	贝立口
裙	衤彐口
哮	口耂子
寿	丰寸Ｓ
攀	木木手
杆	木干Ｇ
旺	日王Ｗ
寇	宀元卜
吾	五口Ｗ
篮	刂皿
狄	犭火Ｄ
储	亻讠者
鉴	刂金
嘀	口啇Ｄ
虏	虍力Ｌ
嚎	口亮豕
赋	贝一弋
隙	阝小小
炉	火户Ｌ
呻	口日丨
殷	彐殳
污	氵二Ｓ
辩	辛讠辛
篇	户冊
嗓	口又木
吊	口巾Ｄ
播	扌丿田
颊	夫丷页
偿	亻云
冤	冖兔Ｙ
耿	耳火Ｇ
俯	亻广寸
俄	亻手戈
躁	口木
狞	犭宁Ｎ
嗔	口十八
廖	广羽彡
罕	干Ｈ
狡	犭亠父
溅	氵贝戈
蹲	酋寸
焕	火大
缕	纟米女
嘎	口丆戈
烤	火耂丂
渴	氵日勹
篷	夂辶
乏	丿之Ｆ
擒	扌人冂
棠	尚木Ｔ
粒	米立Ｌ
祺	礻其Ｑ
惩	彳一心
患	口口心
谦	讠首兼
汪	氵王Ｗ
押	扌甲Ｙ
辨	辛刂辛
蛛	虫朱Ｚ
歹	歹ＤＩ
蕴	艹纟皿
沸	氵弓刂
遣	虫官辶
陶	阝勹缶
迁	千辶Ｑ
版	片反Ｂ
咆	口包Ｐ
彷	彳方Ｐ
囊	十口ｒ
劣	少力Ｌ
芝	艹之Ｚ
潇	氵艹川
鳞	鱼米舛
甫	甫ＦＵ
逢	夂丰辶
玫	王攵Ｍ
狈	犭贝Ｂ
邓	又阝Ｄ
侦	亻卜贝
炽	火口八
竭	立日勹
讽	讠风Ｆ
挠	扌戈儿
拓	扌石Ｔ
戮	羽彡戈
订	讠丁Ｄ
苟	艹勹口
娶	耳又女
蔡	艹祭示
丸	九丶Ｗ
佐	亻工
宅	宀丿七
厢	厂木目
驳	马乂乂
拐	扌另Ｇ
昭	日召Ｚ
弦	弓玄Ｘ
淑	氵卜又
叠	又又且
俞	亼前Ｙ
辜	古辛Ｇ
兼	首彐兼
吱	口十又
腻	月弋二
础	石出Ｃ
兮	八丂Ｘ
琉	王充川
蓬	艹夂辶
厮	厂其斤
坡	土皮Ｐ
咪	口米Ｍ
朴	木卜Ｐ
妍	女一廾
胎	月厶口
刮	舌刂Ｇ
苗	艹田Ｍ
廊	广丶阝
遵	酋寸辶
蜀	罒勹虫
倭	亻禾女
浸	氵彐又
滞	氵卅巾
梭	木厶夂
湾	氵亦弓
韦	二卩Ｗ
玻	王皮Ｂ
禀	亠囗示
茹	艹女口
敛	亼兴攵
澜	氵门木
聂	耳又又
疏	乛止川
瞎	目宀口
豆	一口首
溢	氵首皿
犬	大丶Ｑ
廉	广首兼
潘	氵丿田
嗦	口十小
祈	礻斤Ｑ
灼	火勹丶
瞥	丷攵目
斑	王文王
顽	元页Ｗ
兹	首幺幺
糕	米灬
昊	日一大
锅	钅口内
缚	纟甫寸
妞	女丑Ｎ
匠	匚斤Ｊ
魁	白儿斗
鹤	冖隹鸟
绯	纟非Ｆ
谎	讠艹川
榜	木旁方
碌	石彐水
拂	扌弓刂
壶	士冖业
昧	日未Ｍ
遁	十辶
蔽	艹巾攵
庙	广由Ｍ
蹄	旁巾
茜	艹西Ｘ
腔	月穴工
堕	阝土
耽	耳巾乚
硕	石页Ｓ
壳	士冖几
彪	虍几彡
肠	月Ｊ彳
钰	钅王丶
岭	山亽
嗡	口八羽
栋	木七小
葬	艹歹廾
冉	冂土Ｒ
挪	扌月阝
鞋	革圭Ｘ
蹦	山月
柴	止匕木
蔓	艹日又
陀	阝宀匕
姊	女丿Ｓ
啧	口贝
妨	女方Ｆ
窃	穴七刀
阎	门臼
盆	分皿Ｐ
焚	林火Ｆ
矢	矢ＳＩ
携	扌隹乃
钉	钅丁Ｄ
帘	穴巾Ｌ
俺	亻大乚
嗤	口屮虫
萝	艹罒夕
沧	氵仓Ｃ
循	彳目
搅	扌学见
渺	氵目少
兀	一儿Ｗ
狭	犭夫丷
戟	十十戈
申	日丨Ｓ
翘	戈儿羽
嘱	口尸冂
拆	扌斤丶
津	氵彐干
贱	贝一戈
汝	氵女Ｒ
暇	日尸又
愉	忄亼前
侄	亻一土
棵	木日木
谭	讠覀十
轨	车九Ｇ
蚁	虫丶乂
啥	口亼古
媒	女廿木
噗	口业丶
锻	钅Ｅ殳
赴	走卜Ｆ
诈	讠乍Ｚ
巢	巛日木
捡	扌亼兴
哟	口纟勹
衷	衣口丨
吁	口于Ｙ
彦	立丿彡
渗	氵厶彡
峡	山夫丷
涡	氵口内
禅	礻丷十
氓	亡巳七
浆	丬夕水
租	禾且Ｚ
阅	门丷口
掐	扌臼
帽	巾日目
揭	扌日勹
妒	女户Ｄ
毙	比歹匕
寞	宀莫Ｍ
孝	耂子Ｘ
乙	乙ＹＩ
贸	Ｃ刀贝
革	革ＧＥ
喔	口尸土
憋	丷攵心
蓄	艹玄田
坎	土欠Ｋ
舅	臼田力
絮	女口小
烛	火虫Ｚ
歆	立日欠
胞	月包Ｂ
翰	十十羽
颖	匕禾页
彤	冂亠彡
唔	口五口
垃	土立Ｌ
圾	土及Ｊ
尧	戈一儿
旭	九日Ｘ
寄	宀大可
喀	口宀各
遂	首豕辶
阱	阝井Ｊ
泊	氵白Ｂ
妾	立女Ｑ
瑰	王白儿
虐	虍ＥＮ
潭	氵覀十
祀	礻巳Ｓ
逻	罒夕辶
璇	王族止
税	禾丷儿
嫂	女叟Ｓ
填	土十八
蛟	虫亠父
怯	忄土厶
滔	氵爫臼
弧	弓瓜Ｈ
惫	夂田心
煌	火白王
雍	亠丿隹
衍	彳氵亍
笛	由Ｄ
庸	广彐冃
兆	ＫＫＺ
咚	口夂冫
暮	莫日Ｍ
卜	卜ＢＵ
裳	尚衣Ｓ
沫	氵末Ｍ
蝎	虫日勹
寡	宀丆分
蚀	饣虫Ｓ
枉	木王Ｗ
粹	米亠十
澡	氵口木
昔	日Ｘ
摘	扌啇Ｚ
瀚	氵人羽
寝	宀丬又
熙	匚巳灬
舜	爫夕舛
售	隹口Ｓ
栽	十戈木
胧	月龙Ｌ
贞	卜贝Ｚ
诅	讠且Ｚ
滩	氵又隹
韧	二卩刀
倚	亻大可
睹	目者Ｄ
栈	木一戈
蝠	虫畐Ｆ
桶	木用
卦	圭卜Ｇ
臀	尸殳冃
狰	犭亅
姚	女ＫＫ
雇	户隹Ｇ
署	罒者Ｓ
狙	犭且Ｊ
泼	氵发Ｐ
诛	讠朱Ｚ
朦	月营豕
栏	木首二
筒	冂一
哧	口土亦
溪	氵爫大
册	册ＣＥ
窥	穴夫见
湘	氵木目
犀	尸氺牛
舔	舌一
剥	彐水刂
磁	石首幺
惕	忄日勹
旷	日广Ｋ
佑	亻口
歼	歹千Ｊ
兜	Ｃ尸儿
窟	穴尸出
枕	木巾乚
囚	囗人Ｑ
裴	非衣Ｐ
胀	月长Ｚ
楠	木Ｍ首
觑	虍业见
擂	扌雨田
拽	扌日乚
捣	扌鸟山
蕊	艹心心
巷	八巳
乞	乙Ｑ
谱	讠首日
蚩	屮一虫
哩	口里Ｌ
琢	王豕丶
垒	厶厶土
胃	田冃Ｗ
虞	虍口大
绣	纟禾乃
衰	衣口Ｓ
扁	户冊Ｂ
菩	艹立口
颅	卜尸页
骆	马各Ｌ
抄	扌少Ｃ
菁	艹青Ｊ
纽	纟丑Ｎ
贡	工贝Ｇ
噢	口白大
桓	木一一
绮	纟大可
戚	戊卜一
惟	忄隹Ｗ
慑	忄耳又
罡	罒一止
喧	口宀一
衙	彳五亍
瑜	王亼前
岗	山冂乂
侃	亻口川
祷	礻丰寸
萍	落干丷
剂	文刂刂
莽	艹大廾
诞	讠丿廴
轴	车由Ｚ
嘘	口虍业
烫	氵Ｊ火
咙	口龙Ｌ
鞘	革冃
丞	乛水一
剿	巛木刂
孽	艹追子
淘	氵勹缶
翎	亽羽
翁	八厶羽
恕	女口心
衬	衤寸Ｃ
倦	亻
揽	扌见
疚	疒丶
轿	车丿刂
秃	禾几Ｔ
猾	犭骨Ｈ
钦	钅欠Ｑ
嗜	口耂日
掷	扌丷阝
藉	艹耒日
鸦	一才鸟
陨	阝口贝
熬	敖灬Ａ
窍	穴工丂
郝	土亦阝
芷	艹止Ｚ
咖	口加Ｋ
勋	口贝力
铸	钅丰寸
叨	口刀Ｄ
乍	乍ＺＡ
磕	石土皿
扳	扌反Ｂ
霎	雨立女
姥	女耂匕
棺	木宀官
奢	大者Ｓ
辟	尸口辛
叙	余又Ｘ
畜	玄田Ｘ
嫉	女疒矢
蜘	虫矢口
搁	扌门各
钥	钅月Ｙ
陋	阝一乚
茅	艹才
倏	亻夂大
瘫	疒又隹
菊	艹勹米
匙	日止匕
翩	户冊羽
倘	亻尚Ｔ
擎	艹攵手
趋	走彐
窄	穴乍Ｚ
峻	山厶夂
啡	口非Ｆ
嗽	口木欠
醋	酉日
酥	酉禾Ｓ
伺	亻一
恳	艮心Ｋ
粘	米占Ｎ
哆	口夕夕
绞	纟亠父
绷	纟月月
丐	一卜Ｓ
渠	氵匚木
娱	女口大
佘	人示Ｓ
淌	氵尚Ｔ
履	尸彳夂
塑	丷月土
症	疒一止
衔	彳钅亍
蔑	艹罒戊
禽	人文冂
傀	亻白儿
蛊	虫皿Ｇ
炀	火Ｊ彳
捞	扌营力
蒸	艹乛灬
缄	纟戊一
嗖	口叟Ｓ
炫	火玄Ｘ
眩	目玄Ｘ
歧	止十又
邱	丘阝Ｑ
挟	扌夫丷
帆	巾几丶
莺	营鸟Ｙ
渔	氵鱼Ｙ
敞	尚攵Ｃ
绰	纟卜十
淳	氵高子
厥	厂丷欠
瞟	目覀示
霹	雨尸辛
疤	疒巴Ｂ
柏	木白Ｂ
徽	微幺小
讪	讠山Ｓ
猿	犭土ｒ
沮	氵且Ｊ
眶	目匚王
页	页ＹＥ
卸	止卩
宵	宀冃
惭	忄车斤
菱	艹土夂
踹	山皿
肿	月口丨
萱	萱一一
斐	非文Ｆ
钩	钅勹厶
瓷	冫欠瓦
雳	雨厂力
茂	艹戊Ｍ
肺	月一巾
届	尸由Ｊ
鹫	高丶鸟
碑	石卑Ｂ
儡	亻田田
蝉	虫丷十
夭	丿大Ｙ
娟	女口冃
曰	曰ＹＥ
淮	氵隹Ｈ
拘	扌勹口
搓	扌工
捅	扌用
豁	宀口谷
亨	高乛亅
荐	艹Ｐ子
漩	氵族止
捆	扌囗木
沼	氵召Ｚ
迭	失辶Ｄ
侮	亻母
叱	口匕Ｃ
槐	木白儿
迸	首廾辶
扛	扌工Ｋ
屡	尸米女
鲍	鱼包Ｂ
脊	ＫＫ月
忖	忄寸Ｃ
婢	女卑Ｂ
栗	覀木Ｌ
驼	马宀匕
贩	贝反Ｆ
芦	艹户Ｌ
拎	扌亽
彬	林彡Ｂ
姗	女册Ｓ
淹	氵大乚
怠	厶口心
钧	钅勹冫
嗅	口丿大
樊	木木大
弛	弓也Ｃ
霓	雨臼儿
揍	扌大
喽	口米女
汁	氵十Ｚ
惮	忄丷十
邻	亽阝
蟒	虫艹廾
衅	丿皿半
瘾	疒阝心
账	贝长Ｚ
览	刂见
妩	女干乚
厦	厂丆夂
妆	丬女Ｚ
芊	艹千Ｑ
抿	扌巳七
喻	口亼前
吏	丈口Ｌ
澈	氵充攵
砖	石二
僻	亻尸辛
倪	亻臼儿
挫	扌人土
杏	木口Ｘ
襄	衣口口
桐	木冂一
矣	厶矢Ｙ
噩	王口口
揪	扌禾火
拧	扌宁Ｎ
燥	火口木
郊	亠父阝
喇	口木刂
沦	氵人匕
蚂	虫马Ｍ
阮	阝元Ｒ
帖	巾占Ｔ
戬	亚日戈
铲	钅立丿
孕	乃子Ｙ
跺	几木
巅	山八页
敦	高子攵
婪	林女Ｌ
蹈	爫臼
蹭	丷日
株	木朱Ｚ
凹	凹ＡＯ
婿	女乛冃
嬉	女吉口
盐	土卜皿
冀	丬匕八
膜	月莫Ｍ
剪	首前刀
鞠	革勹米
桂	木圭Ｇ
盏	一戈皿
襟	衤林示
逞	口王辶
棘	木冂木
焉	一Ｓ灬
跋	犮Ｂ
呕	口匚乂
稚	禾隹Ｚ
嵌	山廿欠
熠	火羽白
颓	禾几页
妓	女十又
穹	穴弓Ｑ
邵	召阝Ｓ
涣	氵大
债	亻贝
梧	木五口
勿	勹彳Ｗ
墟	土虍业
焱	火火火
桩	木广土
脯	月甫Ｆ
镶	钅衣口
拭	扌弋工
忿	分心Ｆ
撩	扌大小
涟	氵车辶
谍	讠世木
拇	扌母Ｍ
瑾	王廿
疫	疒殳Ｙ
掘	扌尸出
梨	禾刂木
窒	穴一土
朽	木丂Ｘ
奕	亦大Ｙ
涅	氵日土
顷	匕页Ｑ
咋	口乍Ｚ
酬	酉州Ｃ
琦	王大可
蝙	虫户冊
吭	口亠几
僚	亻大小
镰	钅广兼
砚	石见Ｙ
瞅	目禾火
饥	饣几Ｊ
邸	Ｃ七阝
漾	氵水
婕	女一止
胤	儿幺月
呸	口不一
译	讠又干
峙	山土寸
寥	宀羽彡
凸	凸ＴＵ
垫	执土Ｄ
肋	月力Ｌ
噜	口鱼日
漓	氵文冂
剔	日彳刂
猩	犭日
梳	木充川
峨	山手戈
熄	火丿心
睿	卜冖目
禹	丿虫冂
址	土止Ｚ
蝴	虫古月
萌	艹日月
瞻	目言
眷	目Ｊ
蹬	癶首
绘	纟人云
龚	龙八
岔	分山Ｃ
唬	口虍几
飙	大大风
驭	马又Ｙ
漪	氵大可
侥	亻戈儿
肘	月寸Ｚ
侣	亻口口
熏	千黑Ｘ
螺	虫田小
聘	耳由丂
唾	口千垂
幢	巾立里
揣	扌山皿
坊	土方Ｆ
湛	氵其乚
谊	讠宀且
箫	彐川
沛	氵一巾
垮	土大Ｓ
妲	女日一
鹃	口冃鸟
翡	非羽Ｆ
琐	王贝
髓	骨辶
讥	讠几Ｊ
裕	衤谷Ｙ
薪	艹亲斤
毯	毛火火
骸	骨亥Ｈ
癸	癶一大
苹	艹干丷
匿	匚艹
脂	月匕日
玑	王几Ｊ
澎	氵吉彡
枢	木匚乂
懈	忄刀牛
宪	宀儿
搀	扌冫
皓	白告Ｈ
悸	忄禾子
嗷	口敖Ａ
跄	仓Ｑ
镯	钅罒勹
膨	月吉彡
憨	乛攵心
瓣	辛瓜辛
泻	氵冖Ｓ
踉	丶艮
黝	黑幺力
葫	艹古月
渣	氵木一
麾	广林毛
酿	酉丶艮
詹	厂言
沁	氵心Ｑ
眈	目巾乚
畔	田半Ｐ
懊	忄白大
熔	火宀谷
筷	忄夬
霖	雨林Ｌ
综	纟宀示
傍	亻旁方
瑕	王尸又
刁	一Ｄ
嚓	口宀示
惚	忄勹心
践	一戈
兢	古儿儿
尿	尸水Ｎ
秉	禾彐Ｂ
伞	人丷十
崆	山穴工
棉	木白巾
媳	女丿心
坟	土文Ｆ
鹅	手戈鸟
瀑	氵日氺
鲸	鱼高小
逮	彐水辶
糖	米广口
缉	纟口耳
稻	禾爫臼
暧	日爱Ａ
奎	大圭Ｋ
绸	纟冂土
隋	阝冃
狩	犭宀寸
湃	氵一丰
叽	口几Ｊ
饼	饣首廾
靡	广林非
锥	钅隹Ｚ
碟	石世木
拙	扌出Ｚ
簇	族矢
蝇	虫口乚
蚕	一大虫
叩	口卩Ｋ
咸	戊一口
亢	亠几Ｋ
澄	氵癶首
骏	马厶夂
辖	车宀口
媛	女爫又
姻	女囗大
扒	扌八Ｂ
赠	贝丷日
秩	禾失Ｚ
朔	丷山月
倔	亻尸出
嚼	口爫寸
卵	Ｇ冫卩
胶	月亠父
绚	纟勹日
镔	钅穴丘
蚊	虫文Ｗ
唧	口艮卩
炯	火冂口
罐	缶艹隹
浊	氵虫Ｚ
冶	冫厶口
讳	讠二卩
杭	木亠几
弊	丷攵廾
戳	羽隹戈
禄	礻彐水
斋	文丆皿
搐	扌玄田
炙	夕火Ｚ
佬	亻耂匕
聋	龙耳Ｌ
厄	厂Ｅ
凳	癶一几
鲨	氵少鱼
驴	马户Ｌ
盲	亡目Ｍ
锢	钅囗古
锡	钅日勹
诏	讠召Ｚ
伽	亻加Ｊ
铮	钅亅
缭	纟大小
鸭	甲鸟Ｙ
捶	扌千垂
唰	口尸刂
搔	扌又虫
滥	氵皿
恙	心Ｙ
谜	讠米辶
啃	口止冃
啼	口旁巾
驯	马川Ｘ
匣	匚甲Ｘ
悯	忄门文
鸾	亦鸟Ｌ
杉	木彡Ｓ
煜	火日立
拣	扌七小
拯	扌乛一
偎	亻田ｒ
呛	口仓Ｑ
绅	纟日丨
屿	山与Ｙ
煮	者灬Ｚ
璐	王各
冈	冂乂Ｇ
甄	覀土瓦
匈	勹乂凵
钓	钅勹丶
咔	口卜下
笙	丿
桀	夕舛木
蜥	虫木斤
囔	口十ｒ
缴	纟白攵
喳	口木一
泳	氵丶水
睬	目爫木
祟	出示Ｓ
崎	山大可
谣	讠爫缶
晖	日冖车
炭	山火
忑	下心Ｔ
栖	木西Ｑ
娴	女门木
忐	卜一心
榕	木宀谷
堤	土日止
哽	口丈日
烬	火尺冫
炒	火少Ｃ
棱	木土夂
肝	月干Ｇ
靴	革亻匕
痞	疒不口
阀	门亻戈
缪	纟羽彡
赦	土亦攵
殖	歹十且
纲	纟冂乂
璧	尸辛王
厘	厂里Ｌ
泓	氵弓厶
涕	氵丷弓
壤	土衣口
懿	士首心
闺	门圭Ｇ
浇	氵戈儿
匀	勹冫Ｙ
棚	木月月
娲	女口内
蔚	艹尸寸
稽	禾丶日
虾	虫下Ｘ
劭	召力Ｓ
茨	艹冫欠
戾	户大丶
橙	木癶首
厕	厂贝刂
捐	扌口冃
瘟	疒日皿
舵	舟宀匕
芯	艹心Ｘ
晒	日西Ｓ
烙	火各Ｌ
驸	马亻寸
亵	衣执Ｘ
颂	八厶页
钝	钅七凵
窘	穴丿口
懦	忄雨皿
稷	禾田夂
赎	贝十头
袅	鸟衣Ｎ
庶	广廿灬
腮	月田心
绢	纟口冃
葱	艹勹心
溶	氵宀谷
榻	木日羽
吨	口七凵
貂	豸召Ｄ
哉	十戈口
娥	女手戈
悚	忄木口
虔	虍文Ｑ
蹙	戊卜足
婶	女宀丨
屎	尸米Ｓ
磋	石工
殆	歹厶口
诩	讠羽Ｘ
蠕	虫雨皿
偌	亻艹口
拚	扌厶廾
骼	骨各Ｇ
觅	爫见Ｍ
旱	日干Ｈ
裔	衣冂八
昱	日立Ｙ
冕	日儿
屯	七凵Ｔ
惋	忄宀
萎	艹禾女
苑	艹夕
枭	鸟木Ｘ
惺	忄日
砂	石少Ｓ
殴	匚乂殳
叭	口八Ｂ
梢	木冃
缨	纟贝女
蹿	穴丨
飓	风且八
峭	山冃
甸	勹田Ｄ
谐	讠比白
澳	氵白大
聆	耳亽
腊	月日
缜	纟十八
帜	巾口八
昼	尺日一
滕	月氺
茧	艹虫Ｊ
绫	纟土夂
汰	氵大丶
皙	木斤白
踱	广又
嵩	山高Ｓ
兑	丷口儿
诊	讠人彡
葡	艹勹甫
筝	亅
邃	穴首辶
辑	车口耳
獠	犭大小
昕	日斤Ｘ
蜡	虫日
奄	大日乚
诵	讠用
腑	月广寸
悻	忄土十
憎	忄丷日
嗨	口母
敷	甫方攵
庇	广比Ｂ
榴	木刀田
晦	日母
祢	礻小
荀	艹勹日
慷	忄广水
寓	宀甲冂
茉	艹末Ｍ
咄	口出Ｄ
曙	日罒者
噪	口口木
吒	口丿七
缸	缶工Ｇ
幡	巾丿田
啤	口卑Ｐ
烨	火匕十
忡	忄口丨
粥	弓米弓
悴	忄亠十
咏	口丶水
颔	亽口页
洽	氵亼口
募	莫力Ｍ
驿	马又干
藩	落丿田
靶	革巴Ｂ
谬	讠羽彡
憔	忄焦Ｑ
邹	彐阝
痹	疒田丌
绊	纟半Ｂ
酋	酋ＱＵ
框	木匚王
茄	艹加Ｑ
挚	执手Ｚ
萄	艹勹缶
恬	忄舌Ｔ
聿	彐干Ｙ
檀	木亠一
凿	业首凵
璋	王章Ｚ
钞	钅少Ｃ
褐	衤日勹
蟹	刀虫
鬟	髟罒ｒ
铛	钅彐
曦	日戈
崽	山田心
胯	月大Ｓ
璀	王山隹
菇	艹女古
眺	目ＫＫ
瘩	疒艹口
璨	王又米
抡	扌人匕
斟	其乚斗
褪	衤艮辶
涎	氵丿廴
勺	勹丶Ｓ
溟	氵冖八
疙	疒乙
坪	土干丷
猥	犭田ｒ
塘	土广口
揖	扌口耳
逾	亼前辶
冽	冫歹刂
遏	日勹辶
芽	艹一才
裘	氺丶衣
徊	彳囗口
函	乛氺凵
槽	木西日
蟾	虫言
睫	目一止
珂	王可Ｋ
嘭	口吉彡
蒲	落甫Ｐ
煎	首前灬
庚	广彐人
荫	艹阝月
稿	禾高Ｇ
徘	彳非Ｐ
蛙	虫圭Ｗ
睽	目癶大
廓	广高阝
滨	氵穴丘
彰	章彡Ｚ
锵	钅夕寸
掺	扌厶彡
缰	纟一一
芭	艹巴Ｂ
嗒	口艹口
嘈	口西日
暄	日宀一
琅	王丶艮
萤	营虫Ｙ
旬	勹日Ｘ
翱	白十羽
栅	木册Ｚ
缈	纟目少
猝	犭亠十
魇	厂大儿
攒	扌贝
蜴	虫日勹
鞑	革大辶
窿	穴阝
扈	户口巴
蜷	虫
秽	禾山夕
崛	山尸出
谕	讠亼前
袱	衤大丶
瑚	王古月
磅	石旁方
缔	纟旁巾
攸	亻丨攵
缥	纟覀示
惬	忄匚夫
撅	扌厂欠
钮	钅丑Ｎ
阙	门丷山
鸽	亼口鸟
葵	艹癶大
曳	日乚丿
蔼	艹讠勹
礁	石焦Ｊ
苛	艹可Ｋ
佗	亻宀匕
庐	广户Ｌ
珀	王白Ｐ
稠	禾冂土
娉	女由丂
嗣	口冊
饵	饣耳Ｅ
耕	耒井Ｇ
肴	乂冃
渎	氵十头
嵋	山尸目
伶	亻亽
瑭	王广口
懵	忄艹目
饷	饣白口
韬	二卩臼
恃	忄土寸
浦	氵甫Ｐ
邢	一廾阝
咻	口亻木
隧	阝首辶
贷	代贝Ｄ
滢	氵营王
掳	扌虍力
颁	分页Ｂ
芜	艹干乚
檐	木言
祯	礻卜贝
吝	文口Ｌ
蘑	艹广石
咫	尺口八
茬	艹Ｐ土
怦	忄干丷
缀	纟又又
扼	扌厂
唠	口营力
趾	止Ｚ
殃	歹央Ｙ
噼	口尸辛
掂	扌广占
啐	口亠十
羌	乚Ｑ
畴	田丰寸
枷	木加Ｊ
捺	扌大示
禾	禾ＨＥ
绒	纟戈
邮	由阝Ｙ
辙	车充攵
籁	木负
煽	火户羽
戎	戈Ｒ
糙	米告辶
漱	氵木欠
竿	干Ｇ
瘪	疒丿匕
矫	矢丿刂
汀	氵丁Ｔ
吆	口幺Ｙ
怅	忄长Ｃ
攘	扌衣口
叼	口一
昵	日尸匕
烽	火夂丰
猖	犭日日
芥	艹人刂
紊	文幺小
甬	用Ｙ
跷	戈儿
靓	青见Ｌ
栩	木羽Ｘ
簌	木欠
寐	宀爿未
壕	土亮豕
侈	亻夕夕
嫡	女啇Ｄ
黏	禾氺占
亩	亠田Ｍ
酣	酉廿一
舆	臼车八
痊	疒全Ｑ
娆	女戈儿
侏	亻朱Ｚ
佯	亻羊Ｙ
锣	钅罒夕
佼	亻亠父
羲	丂戈
棣	木彐水
鳄	鱼口Ｓ
惘	忄冂首
霏	雨非Ｆ
媲	女白比
蔷	艹十囗
篝	井冂
蛤	虫亼口
虬	虫乚Ｑ
荧	营火Ｙ
舷	舟玄Ｘ
螂	虫丶阝
溺	氵弓弓
羿	羽廾Ｙ
巳	巳ＳＩ
仕	亻士Ｓ
攥	扌小
桦	木匕十
氧	气羊Ｙ
殇	歹Ｊ
捻	扌亽心
胄	由冃Ｚ
臧	戊乚丆
萦	营幺小
漉	氵鹿比
骋	马由丂
券	刀Ｑ
贬	贝丿之
瑛	王艹央
迂	于辶Ｙ
晟	日戊
雏	彐隹
勘	其乚力
煤	火廿木
坞	土乌Ｗ
衮	衣八厶
蓓	艹亻口
蹂	木
蜒	虫丿廴
忒	弋心Ｔ
晏	日安Ｙ
牡	牜土Ｍ
札	木乚Ｚ
缎	纟Ｅ殳
膏	高月Ｇ
屹	山乙
肮	月亠几
哒	口大辶
煦	日勹灬
棕	木宀示
糜	广林米
瞠	目尚土
筱	亻攵
躏	艹门
臻	一土禾
淤	氵人冫
瀛	氵赢女
蹊	爫大
孰	高子九
沪	氵户Ｈ
浙	氵扌斤
毗	田比Ｐ
呱	口瓜Ｇ
磐	舟殳石
矜	才乛
幺	幺ＹＯ
俨	亻亚丿
琥	王虍几
胴	月冂一
暑	日者Ｓ
雌	止匕隹
锯	钅尸古
硝	石冃
酱	丬夕酉
喋	口世木
箍	扌匚
婧	女青Ｊ
玺	小王
羁	罒革马
骁	马戈儿
拈	扌占Ｎ
迢	召辶Ｔ
衲	衤内Ｎ
呗	口贝Ｂ
钵	钅木一
鬓	髟穴丘
剖	立口刂
蜿	虫宀
鞍	革安Ａ
伫	亻宀一
恤	忄丿皿
铿	钅又土
鸳	夕鸟
蝗	虫白王
茸	艹耳Ｒ
赃	贝广土
谴	讠虫辶
邑	口巴Ｙ
俐	亻禾刂
吮	口厶儿
刊	干刂Ｋ
钳	钅廿一
亥	亥ＨＩ
噎	口士首
巩	工几丶
驹	马勹口
薰	艹千黑
踌	丰寸
饕	口虍食
矗	十且且
躇	艹者
蹑	耳又
弑	乂朩弋
崭	山车斤
褚	衤者Ｃ
湮	氵覀土
踞	尸古
恺	忄山己
鸠	九鸟Ｊ
邯	廿一阝
渍	氵贝
汴	氵亠卜
蜈	虫口大
惦	忄广占
谑	讠虍Ｅ
砌	石七刀
辎	车巛田
贿	贝冃
癫	疒十页
诫	讠戈廾
赘	敖贝Ｚ
伎	亻十又
铐	钅耂丂
诣	讠匕日
匡	匚王Ｋ
岌	山及Ｊ
旎	族尸匕
锈	钅禾乃
桅	木
鸯	央鸟Ｙ
鲲	鱼日比
莞	萱元Ｇ
玮	王二卩
剌	木口刂
茱	艹朱Ｚ
祁	礻阝Ｑ
奠	酋大Ｄ
岱	代山Ｄ
辫	辛纟辛
闵	门文Ｍ
燎	火大小
椒	木卜又
缇	纟日止
惴	忄山皿
疮	疒仓Ｃ
酌	酉勹丶
窖	穴告Ｊ
邬	乌阝Ｗ
呦	口幺力
顼	王页Ｘ
岐	山十又
捋	扌爫寸
飕	风叟Ｓ
楮	木者Ｃ
帷	巾隹Ｗ
笃	马Ｄ
噔	口癶首
骰	骨殳Ｔ
鄂	口Ｓ阝
珏	王王丶
汩	氵曰Ｇ
鑫	金金金
嘤	口贝女
掰	分手
峦	亦山Ｌ
冢	冖豕丶
瓮	八厶瓦
唏	口乂巾
蟆	虫莫Ｍ
掣	牛刂手
隘	阝首皿
瞩	目尸冂
茗	艹夕口
哝	口巾ｒ
拷	扌耂丂
蚣	虫八厶
慵	忄广冃
洼	氵圭Ｗ
牟	厶牛Ｍ
娄	米女Ｌ
敝	丷巾攵
孜	子攵Ｚ
龌	止凵土
餮	歹人食
窦	穴十头
烘	火八
咣	口儿
飒	立风Ｓ
咎	夂卜口
憧	忄立里
逵	土八辶
闽	门虫Ｍ
啷	口丶阝
睨	目臼儿
铅	钅几口
楷	木比白
绎	纟又干
皎	白亠父
龊	止凵足
阉	门大日
黠	黑吉Ｘ
隼	隹十Ｓ
菌	艹囗禾
钗	钅又丶
诶	讠厶矢
杠	木工Ｇ
靥	厂大罒
饲	饣一
蜃	厂ｒ虫
筛	刂巾
淼	水水水
粪	米八
颍	匕水页
喏	口艹口
苔	艹厶口
啬	十首囗
闸	门甲Ｚ
憬	忄日小
伢	亻一才
酝	酉云Ｙ
柬	木柬Ｊ
啄	口豕丶
窑	穴缶Ｙ
旖	族大可
喵	口艹田
寰	宀罒ｒ
羔	灬Ｇ
膳	月羊口
缅	纟丆罒
垣	土一一
筠	土勹
乒	丘丿Ｐ
榨	木穴乍
笈	及Ｊ
瞑	目冖八
剁	几木刂
奚	爫幺大
兖	亠八儿
庵	广大乚
瓒	王贝
孺	子雨皿
梓	木辛Ｚ
杵	木午Ｃ
扉	户非Ｆ
诲	讠母
坍	土冂亠
咂	口匚巾
噤	口林示
峥	山亅
纶	纟人匕
壑	卜又土
殉	歹勹日
辐	车畐Ｆ
蜕	虫丷儿
唆	口厶夂
阖	门土厶
谛	讠旁巾
穗	禾士心
琶	王王巴
螳	虫尚土
盎	央皿Ａ
褒	衣亻口
贲	十艹贝
毋	毋ＷＵ
淬	氵亠十
藻	落氵木
粟	覀米Ｓ
袜	衤末Ｗ
佟	亻夂冫
簸	其皮
苇	艹二卩
醇	酉高子
枣	木冂冫
拗	扌幺力
椎	木隹Ｚ
橡	木象Ｘ
蹋	日羽
遐	尸尸辶
拌	扌半Ｂ
馋	饣冫
橘	木冂
霭	雨讠勹
啜	口又又
撮	扌日又
馒	饣日又
纬	纟二卩
嬴	赢女Ｙ
潺	氵尸子
筏	亻戈
宦	宀匚丨
娑	氵少女
鹭	各鸟
玎	王丁Ｄ
抉	扌夬Ｊ
匍	勹甫Ｐ
蕃	艹丿田
恻	忄贝刂
乓	丘丶Ｐ
苞	艹包Ｂ
胥	乛止冃
帛	白巾Ｂ
驮	马大Ｔ
痪	疒大
碾	石尸ｒ
陕	阝夫丷
嬷	女广厶
髯	髟冂土
嫦	女尚巾
耷	大耳Ｄ
阑	门木柬
迳	又工辶
弈	亦廾Ｙ
眦	目止匕
侬	亻巾ｒ
娓	女尸毛
噘	口厂欠
炬	火匚尸
沥	氵厂力
曜	日羽隹
禧	礻吉口
陇	阝龙Ｌ
咛	口宁Ｎ
砾	石Ｃ小
竺	二Ｚ
胭	月囗大
涧	氵门日
墩	土高攵
呲	口止匕
篡	目厶
昙	日云Ｔ
蟠	虫丿田
旌	族丿
睦	目土土
羹	灬大
琵	王王比
咀	口且Ｊ
馅	饣臼
讷	讠内Ｎ
磷	石米舛
孵	Ｇ爫子
濒	氵止页
亘	一日一
簧	八
诬	讠工人
擞	扌米攵
魃	白儿犮
瓯	匚乂瓦
曝	日日氺
删	册刂Ｓ
徨	彳白王
宓	宀心丿
桨	丬夕木
楣	木尸目
铎	钅又干
剐	口内刂
匐	勹畐Ｆ
腆	月冂八
谏	讠木柬
粼	米夕巛
阐	门丷日
婀	女阝可
邺	业阝Ｙ
纨	纟九丶
辗	车尸ｒ
卉	十廾Ｈ
偃	亻匚日
鹊	日鸟
槛	木皿
荼	艹余Ｔ
锭	钅宀止
瘴	疒章Ｚ
瑙	王巛白
皂	白七Ｚ
踝	日木
铳	钅充儿
锄	钅且力
剃	丷丿刂
吠	口大丶
蛰	执虫Ｚ
琰	王火火
叟	叟ＳＵ
缤	纟穴丘
颌	亼口页
珈	王加Ｊ
浏	氵文刂
卤	卜囗乂
匾	匚户冊
飚	风火火
刨	包刂Ｐ
杞	木己Ｑ
馁	饣爫女
瘸	疒加内
榭	木身寸
绛	纟夂舛
姒	女以Ｓ
殒	歹口贝
瓢	覀示瓜
窈	穴幺力
栓	木全Ｓ
婊	女ｒ
譬	尸辛言
谄	讠臼
垠	土艮Ｙ
壹	士冖首
呤	口亽
烹	高乛灬
靳	革斤Ｊ
丕	不一Ｐ
蕉	艹焦Ｑ
隅	阝甲冂
礴	石落寸
嫖	女覀示
炊	火欠Ｃ
珞	王各Ｌ
挲	氵少手
蛾	虫手戈
膺	广亻冃
猬	犭田冃
潞	氵各
筐	匚王
骜	敖马Ａ
俑	亻用
鳌	敖鱼Ａ
稣	鱼禾Ｓ
蒜	艹示示
窕	穴ＫＫ
腋	月亠夂
魑	白儿文
芮	艹内Ｒ
簪	旡日
麴	木夂勹
黔	黑亽乛
垢	土Ｆ口
屉	尸世Ｔ
馀	饣余Ｙ
笋	彐丿
轼	车弋工
汲	氵及Ｊ
迥	冂口辶
垄	龙土Ｌ
弼	弓丆弓
沣	氵丰Ｆ
稼	禾宀豕
纣	纟寸Ｚ
郢	口王阝
藐	艹豸儿
寅	穴一由
戍	戊丶Ｓ
簿	氵寸
拄	扌主Ｚ
泌	氵心丿
渲	氵宀一
嚏	口十止
呓	口艹乙
篆	彑豕
斓	文门木
鲤	鱼里Ｌ
熹	吉首灬
圭	圭ＧＩ
锏	钅门日
螃	虫旁方
茎	艹又工
龇	止凵匕
丙	一内Ｂ
皑	白山己
睚	目厂圭
撂	扌田各
惆	忄冂土
鸥	匚乂鸟
嚅	口雨皿
炳	火一内
谧	讠心皿
篱	文冂
跚	册Ｓ
渤	氵十力
螓	虫禾
矶	石几Ｊ
梗	木丈日
岑	山亽乛
槌	木追辶
糗	米丿大
滤	氵虍心
蛆	虫且Ｑ
拴	扌全Ｓ
晁	日ＫＫ
犷	犭广Ｇ
潼	氵立里
灶	火土Ｚ
踵	千里
坝	土贝Ｂ
髻	髟吉Ｊ
嗲	口父夕
袒	衤日一
晔	日匕十
碳	石山火
麓	林鹿比
渝	氵亼前
涔	氵山乛
卯	Ｇ卩Ｍ
菡	艹乛凵
泯	氵巳七
撬	扌毛毛
羚	亽
抠	扌匚乂
嗬	口艹可
馈	饣贵Ｋ
骠	马覀示
凋	冫冂土
赂	贝各Ｌ
噌	口丷日
鸨	匕十鸟
苜	艹目Ｍ
幌	巾日儿
褥	衤厂寸
嘹	口大小
袂	衤夬Ｍ
荤	营车Ｈ
囤	囗七凵
裆	衤彐
盅	口丨皿
醺	酉千黑
萃	艹亠十
赧	土亦又
婵	女丷十
氤	气囗大
腼	月丆罒
梆	木丰阝
涸	氵囗古
釜	父干首
镭	钅雨田
椭	木冃
祠	礻一
硫	石充川
晤	日五口
隗	阝白儿
痉	疒又工
笺	一戈
饺	饣亠父
睐	目未丷
峒	山冂一
涤	氵夂朩
俸	亻干
玟	王文Ｗ
谪	讠啇Ｚ
渥	氵尸土
劾	亥力Ｈ
氲	气日皿
挛	亦手Ｌ
蹒	艹两
霈	雨氵巾
舫	舟方Ｆ
鳅	鱼禾火
苋	艹见Ｘ
琬	王宀
怏	忄央Ｙ
嗫	口耳又
瞰	目乛攵
蚌	虫丰Ｂ
溯	氵丷月
沓	水日Ｔ
翌	羽立Ｙ
蜻	虫青Ｑ
甭	不用Ｂ
唷	口充冃
藕	艹耒冂
疵	疒止匕
啾	口禾火
绔	纟大Ｓ
毓	母川
桉	木安Ａ
癖	疒尸辛
蝼	虫米女
韶	立日召
霁	雨文刂
蔬	艹止川
跤	亠父
甥	丿力
颐	匚丨页
怂	人人心
炕	火亠几
咿	口彐丿
咤	口宀七
毡	毛占Ｚ
桔	木吉Ｊ
鳖	丷攵鱼
弋	弋ＹＩ
撰	扌巳八
晾	日高小
泞	氵宁Ｎ
嗝	口一冂
霾	雨豸里
蟑	虫章Ｚ
臌	月十又
掬	扌勹米
绾	纟宀官
獒	敖大丶
璞	王业丶
臊	月口木
臾	臼人Ｙ
恸	忄云力
贮	贝宀一
阂	门亥Ｈ
岖	山匚乂
翟	羽隹Ｄ
咨	冫欠口
堑	车斤土
倡	亻日日
忏	忄千Ｃ
妤	女丁
啵	口氵皮
殛	歹乛一
瞌	目土皿
哐	口匚王
圃	囗甫Ｐ
蛹	虫用
俭	亻亼兴
灸	丶火
剽	覀示刂
缆	纟见
橱	木厂寸
秤	禾干丷
搪	扌广口
嗥	口白十
粲	卜又米
钛	钅大丶
圳	土川Ｚ
邕	巛口巴
畿	幺戈田
鹦	贝女鸟
淀	氵宀止
褂	衤圭卜
瘤	疒Ｃ田
忤	忄午Ｗ
笠	立Ｌ
挎	扌大Ｓ
渭	氵田冃
糯	米雨皿
祗	礻Ｃ七
肾	刂又冃
恿	用心
垛	土几木
鹉	一止鸟
纺	纟方Ｆ
觎	亼前见
觊	山己见
潋	氵亼攵
猊	犭臼儿
豺	豸才Ｃ
胚	月不一
魍	白儿冂
琛	王木
炜	火二卩
揶	扌耳阝
鬃	髟宀示
汜	氵巳Ｓ
辘	车鹿比
雹	雨包Ｂ
玷	王占Ｄ
撵	扌夫车
颦	止页卑
坳	土幺力
杳	木日Ｙ
荃	艹全Ｑ
揄	扌亼前
摁	扌囗心
咝	口丝一
辄	车耳乚
箩	罒夕
鹞	爫缶鸟
犸	犭马Ｍ
捎	扌冃
潦	氵大小
蚯	虫丘Ｑ
翊	立羽Ｙ
湄	氵尸目
芋	艹于Ｙ
靼	革日一
濑	氵木负
郸	丷十阝
啕	口勹缶
粱	氵刀米
镀	钅广又
汐	氵夕Ｘ
榆	木亼前
淇	氵其Ｑ
魉	白儿两
脓	月巾ｒ
苯	艹木一
赈	贝厂ｒ
觐	廿见
坷	土可Ｋ
篑	贵Ｋ
哂	口西Ｓ
旃	族冂亠
齑	文非刂
荦	营牛Ｌ
裟	氵少衣
辇	夫夫车
幔	巾日又
蘅	艹彳亍
颚	口Ｓ页
犄	牜大可
惰	忄冃
徙	彳止止
蚓	虫弓丨
柿	木亠巾
睥	目卑Ｐ
讹	讠亻匕
嵘	山营木
嗵	口辶
暹	日隹辶
悼	忄卜十
罔	冂首亡
琏	王车辶
蠡	彑虫虫
囵	囗人匕
骊	马一冂
堰	土匚日
趄	走且Ｊ
宸	宀厂ｒ
垦	艮土Ｋ
啻	旁巾口
趔	走歹刂
魈	白儿
麝	鹿比寸
摒	扌尸廾
遢	日羽辶
癌	疒口山
漳	氵章Ｚ
瑁	王日目
硅	石圭Ｇ
斡	十十斗
锚	钅艹田
玳	王代Ｄ
耙	耒巴Ｂ
沽	氵古Ｇ
颉	吉页Ｊ
湍	氵山皿
袤	衣才
卞	亠卜Ｂ
纰	纟比Ｐ
壬	壬ＲＮ
褶	衤羽白
袄	衤丿大
肇	户攵干
犁	禾刂牛
鼾	丿丌干
邋	巛囗辶
忻	忄斤Ｘ
淅	氵木斤
侨	亻丿刂
诽	讠非Ｆ
孪	亦子Ｌ
倨	亻尸古
脐	月文刂
皿	皿ＭＮ
阗	门十且
嘣	口山月
螭	虫文冂
腴	月臼人
骡	马田小
恣	冫欠心
瘠	疒Ｋ月
噶	口艹勹
掸	扌丷十
谙	讠立日
愠	忄日皿
谲	讠冂
叵	匚口Ｐ
痰	疒火火
薯	艹罒者
袈	加衣Ｊ
淄	氵巛田
彗	丰丰彐
恪	忄各Ｋ
孱	尸子子
迄	乙辶
蔫	艹Ｓ灬
蜗	虫口内
癞	疒木负
遑	白王辶
噫	口立心
羯	日勹
鲛	鱼亠父
涓	氵口冃
罂	贝贝缶
褛	衤米女
揩	扌比白
嫔	女穴丘
褴	衤皿
郦	一冂阝
潢	氵八
镑	钅旁方
馥	禾日夂
炖	火七凵
镣	钅大小
瘁	疒亠十
桧	木人云
讧	讠工Ｈ
迩	小辶
涮	氵尸刂
澹	氵言
嶙	山米舛
徵	微王Ｚ
蔻	萱元卜
豚	月豕Ｔ
镂	钅米女
轲	车可Ｋ
篓	米女
禺	甲冂一
樵	木焦Ｑ
遽	虍豕辶
怵	忄木丶
孬	不女子
臃	月亠隹
芹	艹斤Ｑ
挞	扌大辶
偕	亻比白
酆	丰首阝
臼	臼ＪＵ
贽	执贝Ｚ
碉	石冂土
蒯	艹月刂
夙	几歹Ｓ
煊	火宀一
蓁	艹禾
掖	扌亠夂
帚	彐冖巾
泠	氵亽
臆	月立心
粤	白米丂
銮	亦金Ｌ
抒	扌丁
偻	亻米女
庖	广包Ｐ
椰	木耳阝
琮	王宀示
匮	匚贵Ｋ
峋	山勹日
榄	木见
盹	目七凵
轧	车乚Ｚ
诋	讠Ｃ七
夥	日木夕
憩	舌丿心
戛	丆目戈
瞿	目目隹
佻	亻ＫＫ
遨	敖辶Ａ
阜	追十Ｆ
镳	钅鹿灬
蜓	虫壬廴
鏖	鹿比金
摞	扌田小
忪	忄八厶
噙	口人冂
夔	首丿夂
仞	亻刀丶
荑	艹大弓
鸢	弋鸟Ｙ
洱	氵耳Ｅ
姣	女亠父
腺	月白水
泱	氵央Ｙ
捱	扌厂圭
跆	厶口
闾	门口口
犒	牜高Ｋ
琊	王一阝
盂	于皿Ｙ
骥	马匕八
岷	山巳七
鸶	丝丝鸟
痣	疒士心
闳	门厶
帼	巾囗王
碴	石木一
芍	艹勹丶
犊	牜十头
蝈	虫囗王
粽	米宀示
侗	亻冂一
喟	口田冃
傥	亻尚儿
卟	口卜Ｂ
蓟	艹鱼刂
馊	饣叟Ｓ
堇	廿口
踮	广占
冗	冖几Ｒ
倜	亻冂土
蹩	丷攵足
珩	王彳亍
奂	冂大
戌	戊一Ｘ
鄢	一灬阝
濡	氵雨皿
谀	讠臼人
镐	钅高Ｇ
僖	亻吉口
幄	巾尸土
狒	犭弓刂
颛	山皿页
鹧	广廿鸟
箕	其Ｊ
翦	首前羽
摹	莫手Ｍ
愫	忄小
椁	木高子
倌	亻宀官
佝	亻勹口
萼	艹口Ｓ
骧	马衣口
锹	钅禾火
娼	女日日
燮	火火又
弭	弓耳Ｍ
诌	讠彐
泗	氵囗儿
鸪	古鸟Ｇ
洵	氵勹日
雉	矢隹Ｚ
漕	氵西日
怩	忄尸匕
猷	酋大丶
贰	弋二贝
汶	氵文Ｗ
淆	氵乂冃
赣	章夂贝
钊	钅刂Ｚ
轶	车失Ｙ
鳍	鱼耂日
忸	忄丑Ｎ
喙	口彑豕
筵	丿廴
橇	木毛毛
箬	口
祚	礻乍Ｚ
燧	火首辶
沂	氵斤Ｙ
繇	爫缶小
蕙	艹士心
濠	氵亮豕
沅	氵元Ｙ
莆	艹甫Ｐ
砺	石厂
槟	木穴丘
骛	攵马
刽	人云刂
獗	犭厂欠
睑	目亼兴
岈	山一才
牒	片世木
艮	艮ＧＮ
荥	营水Ｘ
妪	女匚乂
诠	讠全Ｑ
悖	忄十子
唳	口户大
纾	纟丁
浃	氵夫丷
狻	犭厶夂
蚱	虫乍Ｚ
钏	钅川Ｃ
搡	扌又木
浣	氵宀元
谗	讠冫
麋	鹿比米
钺	钅戈乚
宕	宀石Ｄ
鹄	告鸟Ｈ
砥	石Ｃ七
杈	木又丶
呷	口甲Ｘ
撸	扌鱼日
邈	豸白辶
膘	月覀示
橄	木乛攵
滟	氵巴
俪	亻一冂
谤	讠旁方
鸩	巾乚鸟
怆	忄仓Ｃ
忾	忄气Ｋ
邝	广阝Ｋ
缮	纟羊口
汾	氵分Ｆ
绉	纟彐
攫	扌目又
畸	田大可
磬	声殳石
蹇	宀井足
钠	钅内Ｎ
贻	贝厶口
舀	爫臼Ｙ
恁	亻壬心
箐	青Ｑ
腓	月非Ｆ
铝	钅口口
赳	走丩Ｊ
沏	氵七刀
氢	气又工
檄	木白攵
坂	土反Ｂ
炷	火主Ｚ
垩	亚土Ｅ
隽	隹乃Ｊ
驽	女又马
陲	阝千垂
泾	氵又工
蹶	厂欠
哺	口甫Ｂ
磺	石八
匝	匚巾Ｚ
讼	讠八厶
掇	扌又又
霰	雨冃攵
哔	口比十
坯	土不一
蘸	艹酉焦
嫒	女爱Ａ
苓	艹亽
遛	Ｃ刀辶
皋	白大十
僮	亻立里
跖	石Ｚ
佞	亻二女
衩	衤又丶
鳗	鱼日又
涿	氵豕丶
翳	匚殳羽
糠	米广水
彝	彑米廾
荔	艹力力
髦	髟毛Ｍ
佶	亻吉Ｊ
娣	女丷弓
胛	月甲Ｊ
铄	钅Ｃ小
诘	讠吉Ｊ
濮	氵业丶
浒	氵讠午
敕	木口攵
逅	Ｆ口辶
姹	女宀七
迤	也辶
巽	巳巳八
钜	钅匚尸
嗑	口土皿
舶	舟白Ｂ
仨	亻三Ｓ
翕	亼口羽
厩	厂艮旡
莓	艹母
颀	斤页Ｑ
锺	钅千里
阚	门乛耳
舄	臼勹灬
孚	爫子Ｆ
呶	口女又
呔	口大丶
蜍	虫余Ｃ
貉	豸各Ｈ
莜	艹亻攵
藜	艹禾氺
肪	月方Ｆ
膻	月亠一
刎	勹彳刂
氅	尚攵毛
聃	耳冂土
泸	氵卜尸
阪	阝反Ｂ
懑	氵艹心
猡	犭罒夕
圜	囗罒一
儆	亻艹攵
逖	犭火辶
聒	耳舌Ｇ
邙	亡阝Ｍ
秣	禾末Ｍ
汕	氵山Ｓ
扪	扌门Ｍ
谒	讠日勹
衾	亽乛衣
龅	止凵包
戗	仓戈Ｑ
姝	女朱Ｓ
昶	丶水日
埔	土甫Ｐ
罄	声殳缶
蛀	虫主Ｚ
嗳	口爱Ａ
绶	纟受Ｓ
汨	氵日Ｍ
谩	讠日又
螟	虫冖八
佥	亼兴Ｑ
邂	刀辶
竣	立厶夂
耘	耒云Ｙ
俾	亻卑Ｂ
沱	氵宀匕
蜚	非虫Ｆ
湫	氵禾火
焊	火日干
砝	石土厶
舐	舌Ｃ七
赝	厂亻贝
恹	忄厂大
蛭	虫一土
滇	氵十八
剜	宀夕刂
昀	日勹冫
缙	纟亚日
鸵	鸟宀匕
樽	木酋寸
俟	亻厶矢
谆	讠高子
裨	衤卑Ｂ
蒺	艹疒矢
涪	氵立口
葩	艹白巴
诃	讠可Ｈ
鞅	革央Ｙ
踊	用
氐	Ｃ七丶
荏	艹亻壬
淙	氵宀示
蹴	尢丶
藓	艹鱼羊
煅	火Ｅ殳
谡	讠田夂
猕	犭小
浚	氵厶夂
淞	氵八厶
瘌	疒木刂
潸	氵林冃
跛	皮Ｂ
桢	木卜贝
坨	土宀匕
俦	亻丰寸
楔	木刀大
铤	钅壬廴
犟	弓虽牛
矍	目目又
菠	落皮Ｂ
诮	讠冃
笆	巴Ｂ
崧	山木厶
绥	纟爫女
獐	犭章Ｚ
溥	氵甫寸
恫	忄冂一
饪	饣壬Ｒ
殄	歹人彡
昴	日Ｇ卩
槿	木廿
牦	牜毛Ｍ
馍	饣莫Ｍ
砧	石占Ｚ
葳	艹戊一
滂	氵旁方
绡	纟冃
鎏	氵充金
骓	马隹Ｚ
醐	酉古月
囱	白夂Ｃ
噱	口虍豕
黜	黑出Ｃ
哓	口戈儿
祛	礻土厶
抨	扌干丷
绺	纟卜口
咩	口羊Ｍ
醍	酉日止
戊	戊ＷＵ
茁	艹出Ｚ
佃	亻田Ｄ
蚤	又丶虫
塾	高九土
谟	讠莫Ｍ
釉	丿米由
谚	讠立彡
诰	讠告Ｇ
锟	钅日比
灞	氵雨月
町	田丁Ｄ
嗄	口丆夂
逡	厶八辶
葭	艹丨又
柩	木匚
滓	氵宀辛
跻	文刂
棂	木彐火
诳	讠犭王
籽	米子Ｚ
囫	囗勹彳
锷	钅口Ｓ
碱	石戊一
奘	爿士大
獬	犭刀牛
夯	大力Ｈ
痿	疒禾女
痍	疒大弓
秧	禾央Ｙ
榷	木冖隹
忱	忄巾乚
鱿	鱼尢丶
圉	囗土首
峪	山谷Ｙ
绌	纟出Ｃ
馗	九首丿
酉	酉ＹＵ
莒	艹口口
嶂	山章Ｚ
酡	酉宀匕
崴	山戊一
镌	钅隹乃
殁	歹殳Ｍ
膑	月穴丘
徇	彳勹日
纭	纟云Ｙ
脶	月口内
鹘	骨鸟Ｇ
腌	月大乚
叁	厶大三
碇	石宀止
晷	日夂口
兕	凹儿Ｓ
渚	氵者Ｚ
刍	彐Ｃ
痘	疒一首
嚯	口雨隹
莅	艹亻立
蛎	虫厂
龛	亼口龙
谔	讠口Ｓ
槊	丷月木
豢	豕Ｈ
胫	月又工
仝	人工Ｔ
佰	亻丆日
碜	石厶彡
殡	歹穴丘
绦	纟夂朩
闩	门一Ｓ
瘀	疒方冫
哞	口厶牛
蓿	萱亻日
驷	马囗儿
玖	王丶
锲	钅刀大
耒	耒ＬＩ
鄱	丿田阝
亟	乛亅一
砣	石宀匕
濯	氵羽隹
俎	人人且
糅	米木
貅	豸亻木
饯	饣一戈
溧	氵覀木
犴	犭干Ａ
诓	讠匚王
訇	勹言Ｈ
嗟	口工
莘	艹辛Ｓ
偈	亻日勹
乜	乚Ｎ
靛	青宀止
郏	夫丷阝
栾	亦木Ｌ
葺	艹口耳
锃	钅口王
螯	敖虫Ａ
泫	氵玄Ｘ
褓	衤口木
懋	木木心
锉	钅人土
镫	钅癶首
掾	扌彑豕
媾	女井冂
桠	木亚Ｙ
枰	木干丷
萋	艹十女
稔	禾亽心
荻	艹犭火
琚	王尸古
侩	亻人云
蝮	虫夂
槁	木高Ｇ
遴	米夕辶
岫	山由Ｘ
皖	白宀元
鹜	攵鸟
皈	白反Ｇ
菟	艹兔Ｔ
蓑	艹衣口
邳	不一阝
蔺	艹门隹
襁	衤弓虽
徉	彳羊Ｙ
盥	臼水皿
幂	冖日巾
觞	用Ｊ
炅	日火Ｇ
貔	豸白比
阡	阝千Ｑ
呖	口厂力
蚨	虫夫Ｆ
溉	氵艮旡
懔	忄亠示
颧	艹隹页
糨	米弓虽
虱	乙丿虫
蜮	虫戈口
舢	舟山Ｓ
铩	钅乂朩
鸷	执鸟Ｚ
砀	石Ｊ彳
咭	口吉Ｊ
腩	月Ｍ首
沆	氵亠几
氮	气火火
忝	一大
抟	扌二
薜	艹尸辛
睢	目隹Ｓ
狴	犭比土
烩	火人云
缃	纟木目
悌	忄丷弓
蝾	虫营木
抻	扌日丨
猢	犭古月
嘞	口革力
爻	乂乂Ｙ
牍	片十头
嶷	山矢止
蒿	艹高Ｈ
骅	马匕十
钹	钅犮Ｂ
嵇	禾丶山
孑	孑ＪＥ
俅	亻氺丶
墒	土商Ｓ
愎	忄夂
囡	囗女Ｎ
饽	饣十子
橐	十口木
梏	木告Ｇ
轸	车人彡
纂	目小
韪	日止二
黢	黑厶夂
羸	赢羊Ｌ
狍	犭包Ｐ
撺	扌穴丨
仃	亻丁Ｄ
殚	歹丷十
鬣	髟巛鼠
樟	木章Ｚ
桎	木一土
呙	口内Ｇ
璺	臼冂王
璎	王贝女
镏	钅刀田
橹	木鱼日
祆	礻一大
酵	酉耂子
徜	彳尚Ｃ
崂	山营力
铀	钅由Ｙ
榔	木丶阝
肓	亡冃Ｈ
镁	钅大
芩	艹亽乛
狲	犭子小
铡	钅贝刂
祉	礻止Ｚ
酪	酉各Ｌ
酗	酉乂凵
擢	扌羽隹
珐	王土厶
鼬	臼鼠由
啮	口止凵
鹑	高子鸟
椿	木日
镞	钅族矢
镛	钅广冃
蜢	虫子皿
檬	木营豕
箔	氵白
饨	饣七凵
貊	豸丆日
馄	饣日比
椋	木高小
寮	宀大小
逦	一冂辶
蝌	虫禾斗
骢	马白心
蛔	虫囗口
辂	车各Ｌ
诿	讠禾女
伥	亻长Ｃ
殓	歹亼兴
挝	扌寸辶
诨	讠冖车
爿	爿ＰＮ
铨	钅全Ｑ
珲	王冖车
楸	木禾火
赊	贝人示
窳	穴瓜瓜
赁	亻壬贝
谌	讠其乚
聩	耳贵Ｋ
煲	亻口火
钨	钅乌Ｗ
茯	艹亻大
摺	扌羽白
罹	罒忄隹
硭	石艹亡
掼	扌毌贝
蚋	虫内Ｒ
旮	九日Ｇ
铣	钅儿
絷	执幺小
辍	车又又
酊	酉丁Ｄ
蛐	虫日刂
暨	艮旡一
蜇	扌斤虫
镝	钅啇Ｄ
肛	月工Ｇ
莠	艹禾乃
砒	石比Ｐ
邴	一内阝
栉	木艹卩
驺	马彐
柠	木宁Ｎ
歃	千臼欠
鳕	鱼雨彐
怼	又寸心
訾	止匕言
鲧	鱼丿小
雒	各隹Ｌ
酩	酉夕口
黩	黑十头
耆	耂匕日
嘬	口日又
孢	子包Ｂ
誊	言Ｔ
斫	石斤Ｚ
媸	女屮虫
岬	山甲Ｊ
嵬	山白儿
泖	氵Ｇ卩
蹉	工
蟊	虫虫
遒	酋辶Ｑ
缛	纟厂寸
轱	车古Ｇ
旯	日九Ｌ
褫	衤几
谯	讠焦Ｑ
纛	小小
僭	亻旡日
妁	女勹丶
孛	十冖子
诟	讠Ｆ口
闱	门二卩
谶	讠人戈
虺	一儿虫
檑	木雨田
榈	木门口
跎	宀匕
牯	牜古Ｇ
煨	火田ｒ
悒	忄口巴
祧	礻ＫＫ
瑗	王爫又
闫	门三Ｙ
蚺	虫冂土
獾	犭艹隹
揆	扌癶大
诙	讠火
嫱	女十囗
囿	囗冃
箸	者Ｚ
啖	口火火
痂	疒加Ｊ
廿	廿ＮＮ
赭	土亦者
蔗	艹广灬
鼹	臼鼠安
篙	高Ｇ
辔	纟纟口
椤	木罒夕
阒	门目大
埠	土追十
伉	亻亠几
嫫	女莫Ｍ
钴	钅古Ｇ
饴	饣厶口
荚	艹夫丷
裾	衤尸古
弁	厶廾Ｂ
衢	彳目亍
阕	门癶一
痔	疒土寸
葆	艹亻木
蟋	虫丿心
锴	钅比白
糸	幺小Ｍ
喑	口立日
岿	山刂彐
豕	豕ＳＩ
蚪	虫斗Ｄ
笞	厶口
晗	日亽口
蟀	虫亠十
菀	萱夕
隍	阝白王
逶	禾女辶
暝	日冖八
茕	营乙十
撷	扌吉页
拮	扌吉Ｊ
獭	犭木负
磔	石舛木
滦	氵亦木
嘁	口戊卜
荇	艹彳亍
搽	扌艹朩
笮	乍Ｚ
胪	月卜尸
滁	氵阝余
泅	氵囗人
湎	氵丆罒
娩	女儿
觥	用儿
饬	饣力
徕	彳未丷
闰	门王Ｒ
掴	扌囗王
璜	王八
唁	口言Ｙ
涝	氵营力
汞	工水Ｇ
傈	亻覀木
錾	车斤金
巯	又工川
鲽	鱼世木
讫	讠乙
俚	亻里Ｌ
姘	女首廾
猁	犭禾刂
菅	萱官Ｊ
耦	耒甲冂
荟	艹人云
谥	讠首皿
绻	纟
肱	月厶
埙	土口贝
铆	钅Ｇ卩
琨	王日比
狎	犭甲Ｘ
哙	口人云
耄	耂匕毛
珉	王巳七
挈	丰刀手
逑	氺丶辶
炻	火石Ｓ
怄	忄匚乂
鳝	鱼羊口
汛	氵乙十
铂	钅白Ｂ
跹	千辶
徭	彳爫缶
埂	土丈日
颢	日小页
猞	犭亼古
铖	钅戊
蓐	艹厂寸
楹	木乃皿
貘	豸莫Ｍ
凼	水凵Ｄ
赅	贝亥Ｇ
稹	禾十八
镗	钅尚土
癣	疒鱼羊
铢	钅朱Ｚ
裱	衤ｒ
倥	亻穴工
涞	氵未丷
阆	门丶艮
傩	亻又隹
钎	钅千Ｑ
蜉	虫爫子
悱	忄非Ｆ
仄	厂人Ｚ
粕	米白Ｐ
纥	纟乙
焘	丰寸灬
珙	王八
栎	木Ｃ小
胰	月大弓
脔	亦内人
缳	纟罒ｒ
觜	止匕用
锝	钅日寸
蕤	艹豕丿
唿	口勹心
柚	木由Ｙ
荜	艹比十
鲫	鱼艮卩
洌	氵歹刂
螈	虫厂小
秆	禾干Ｇ
骞	宀井马
蕲	艹十斤
仵	亻午Ｗ
苻	艹亻寸
斛	用斗
搴	宀井手
瘙	疒又虫
獍	犭竟Ｊ
郗	乂阝
醴	酉日首
铬	钅各Ｇ
篁	白王
杷	木巴Ｐ
烊	火羊Ｙ
郜	告阝Ｇ
纩	纟广Ｋ
脍	月人云
鹂	一冂鸟
牝	牜匕Ｐ
骈	马首廾
莳	艹日寸
熨	尸寸火
钿	钅田Ｄ
冼	冫儿
柑	木廿一
孀	女雨目
恚	圭心Ｈ
氦	气亥Ｈ
湟	氵白王
锒	钅丶艮
锌	钅辛Ｘ
鹬	冂鸟
戕	爿戈Ｑ
缦	纟日又
虻	虫亡Ｍ
篾	罒戊
衽	衤壬Ｒ
帏	巾二卩
轾	车一土
碣	石日勹
膂	族丿冃
堞	土世木
暾	日高攵
鼐	乃爿片
炝	火仓Ｑ
窨	穴立日
鲟	鱼彐寸
偬	亻勹心
硌	石各Ｇ
恽	忄冖车
咴	口火
竦	立木口
邰	厶口阝
虢	爫寸几
覃	覀日十
韭	非一Ｊ
蕨	艹厂欠
铉	钅玄Ｘ
泵	石水Ｂ
帧	巾卜贝
胱	月儿
缟	纟高Ｇ
屐	尸彳又
苌	艹长Ｃ
腱	月彐廴
侔	亻厶牛
鳃	鱼田心
讦	讠干Ｊ
圻	土斤Ｑ
椽	木彑豕
癯	疒目隹
灏	氵日页
洮	氵ＫＫ
拊	扌亻寸
眙	目厶口
尜	小大小
骝	马刀田
髭	髟止匕
蝰	虫大圭
痨	疒营力
竽	于Ｙ
狯	犭人云
剡	火火刂
鼋	元口乚
腚	月宀止
猱	犭木
辚	车米舛
螫	土攵虫
缢	纟首皿
酶	酉母
嘌	口覀示
椴	木Ｅ殳
洹	氵一一
趺	夫Ｆ
盱	目于Ｘ
犍	牜彐廴
镊	钅耳又
噻	口宀土
庹	广廿尺
钙	钅一Ｓ
赡	贝言
罅	缶虍丁
珥	王耳Ｅ
狃	犭丑Ｎ
镙	钅田小
撄	扌贝女
圩	土于Ｘ
杌	木一儿
峄	山又干
箴	戊一
炔	火夬Ｑ
茔	营土Ｙ
墉	土广冃
鏊	敖金Ａ
焙	火立口
馏	饣刀田
畲	人示田
欹	大可欠
洇	氵囗大
吡	口比Ｂ
仟	亻千Ｑ
馐	饣丑
宥	宀冃
鼍	口口乚
苫	艹占Ｓ
囹	囗亽
荛	艹戈儿
氯	气彐水
昃	日厂人
缱	纟虫辶
峤	山丿刂
龈	止凵艮
睇	目丷弓
娈	亦女Ｌ
蹼	业丶
榛	木禾
蟥	虫八
臬	丿目木
殳	殳ＳＵ
擀	扌人干
旄	族毛Ｍ
犰	犭九Ｑ
彀	士弓殳
狁	犭厶儿
诤	讠亅
傣	亻氺
裢	衤车辶
搠	扌丷月
樨	木尸牛
鹌	大乚鸟
踟	矢口
铰	钅亠父
焖	火门心
痢	疒禾刂
锰	钅子皿
厣	厂大甲
瘐	疒臼人
蠹	十虫虫
楫	木口耳
澧	氵日首
郓	冖车阝
秸	禾吉Ｊ
砦	止匕石
璁	王白心
柞	木乍Ｚ
纫	纟刀丶
纡	纟于Ｙ
腭	月口Ｓ
骐	马其Ｑ
黟	黑夕夕
瘿	疒贝女
捭	扌卑Ｂ
芨	艹及Ｊ
笳	加Ｊ
嵯	山工
颏	亥页Ｋ
郧	口贝阝
妣	女比Ｂ
钾	钅甲Ｊ
酃	雨口阝
圄	囗五口
稞	禾日木
苡	艹以Ｙ
杼	木丁
戡	其乚戈
勐	子皿力
薨	艹歹匕
蛉	虫亽
澍	氵吉寸
雩	雨二Ｓ
骘	阝止马
憷	忄林止
茴	艹囗口
诜	讠儿
淖	氵卜十
筅	儿
佚	亻失Ｙ
襦	衤雨皿
郇	勹日阝
吖	口丷丨
檫	木宀示
帔	巾皮Ｐ
垭	土亚Ｙ
凫	鸟几Ｆ
鹗	口Ｓ鸟
钯	钅巴Ｂ
邗	干阝Ｈ
舛	夕舛Ｃ
謇	宀井言
荠	艹文刂
佤	亻瓦Ｗ
矽	石夕Ｘ
喁	口甲冂
粑	米巴Ｂ
垓	土亥Ｇ
苕	艹召Ｓ
浔	氵彐寸
芫	艹元Ｙ
煸	火户冊
蝓	虫亼前
迓	一才辶
杓	木勹丶
躅	罒勹
褡	衤艹口
矾	石几丶
喈	口比白
沔	氵一
樘	木尚土
锨	钅斤欠
蜊	虫禾刂
搦	扌弓弓
鲵	鱼臼儿
烷	火宀元
蕈	艹覀十
刭	又工刂
幛	巾章Ｚ
踯	丷阝
堠	土尸矢
闼	门大辶
愀	忄禾火
鄯	羊口阝
缁	纟巛田
氰	气青Ｑ
瓤	衣口瓜
肜	月彡Ｒ
摈	扌穴丘
氟	气弓刂
瀣	氵又一
鲰	鱼耳又
怫	忄弓刂
坩	土廿一
陉	阝又工
疟	疒ＥＹ
褰	宀井衣
渑	氵口乚
笫	Ｓ丿
裣	衤亼兴
菸	艹方冫
痼	疒囗古
阄	门日
缗	纟巳日
媪	女日皿
疱	疒包Ｐ
悭	忄又土
尻	尸九Ｋ
罴	罒土灬
燹	豕豕火
疥	疒人刂
衿	衤亽乛
艏	舟首目
亳	亮丿七
邛	工阝Ｑ
眭	目圭Ｓ
旒	族充川
茏	艹龙Ｌ
樯	木十囗
艄	舟冃
孳	首幺子
鲶	鱼亽心
卅	卅ＳＡ
黍	禾人氺
鲑	鱼圭Ｇ
氖	气乃Ｎ
怛	忄日一
枋	木方Ｆ
蒹	艹首兼
菘	艹木厶
豌	一首
泶	学水Ｘ
笏	勹彳
忉	忄刀Ｄ
淝	氵月巴
榉	木兴干
踽	丿冂
廪	广亠示
裎	衤口王
桁	木彳亍
萑	艹隹Ｈ
濂	氵广兼
鲈	鱼卜尸
疹	疒人彡
逋	甫辶Ｂ
栳	木耂匕
蚍	虫比Ｐ
苒	艹冂土
蝣	虫族子
铙	钅戈儿
殍	歹爫子
陂	阝皮Ｂ
埚	土口内
麂	鹿比几
妊	女壬Ｒ
唢	口贝
锗	钅者Ｚ
擘	尸辛手
趸	丆足
赍	十人贝
谰	讠门木
歙	亼羽欠
縻	广林小
焯	火卜十
矬	矢人土
烯	火乂巾
荩	艹尺冫
艨	舟营豕
眇	目少Ｍ
瓴	亽瓦
亍	亍ＣＵ
佧	亻卜下
叻	口力Ｌ
箝	扌廿
勰	力力心
氨	气安Ａ
喱	口厂里
飨	丝丿食
翥	者羽Ｚ
侪	亻文刂
桫	木氵少
鲠	鱼丈日
茑	艹鸟Ｎ
蚝	虫毛Ｈ
跗	亻寸
焓	火亽口
洄	氵囗口
疽	疒且Ｊ
笤	召Ｔ
篦	白比
鹕	古月鸟
雎	且隹Ｊ
胺	月安Ａ
蹰	厂寸
阋	门臼儿
钬	钅火Ｈ
镪	钅弓虽
馕	饣十ｒ
艟	舟立里
毂	士车殳
鹈	丷丿鸟
庠	广羊Ｘ
猗	犭大可
瞽	吉十目
疴	疒可Ｋ
踅	扌斤足
棼	林分Ｆ
睾	丿罒十
鹳	艹隹鸟
疡	疒Ｊ彳
锍	钅充川
漭	氵艹廾
跸	比十
醮	酉焦Ｊ
砬	石立Ｌ
濉	氵目隹
柢	木Ｃ七
泷	氵龙Ｌ
逄	夂舛辶
埘	土日寸
陟	阝止少
耋	耂匕土
笄	一廾
蚧	虫人刂
蝥	攵虫
塄	土罒方
萘	艹大示
郯	火火阝
烃	火又工
酮	酉冂一
彖	彑豕Ｔ
痫	疒门木
鼙	吉十卑
掮	扌户冃
趿	及Ｔ
帑	女又巾
馔	饣巳八
鲇	鱼占Ｎ
畦	田圭Ｑ
蚜	虫一才
枸	木勹口
狷	犭口冃
尢	尢ＹＵ
稗	禾卑Ｂ
窠	穴日木
溘	氵土皿
矸	石干Ｇ
岢	山可Ｋ
沭	氵木丶
钲	钅一止
蠃	赢虫Ｌ
睃	目厶夂
庾	广臼人
扦	扌千Ｑ
鸱	Ｃ七鸟
哚	口几木
菔	艹月又
枥	木厂力
轳	车卜尸
蟛	虫吉彡
觋	工人见
祜	礻古Ｈ
蚰	虫由Ｙ
狳	犭余Ｙ
倬	亻卜十
锱	钅巛田
蛄	虫古Ｇ
醪	酉羽彡
囟	白乂Ｘ
爰	爫干又
奁	大匚乂
擤	扌丿丌
槎	木工
鞒	革丿刂
嬗	女亠一
嗉	口小
鳐	鱼爫缶
柘	木石Ｚ
毖	比心丿
舸	舟可Ｇ
镍	钅丿木
鋈	氵丿金
潆	氵营小
侑	亻冃
谘	讠欠口
耔	耒子Ｚ
锕	钅阝可
豳	山豕豕
芾	艹一巾
乩	占乚Ｊ
渌	氵彐水
禳	礻衣口
綦	其幺小
锑	钅丷弓
钤	钅亽乛
砭	石丿之
鳏	鱼罒冫
辊	车日比
娠	女厂ｒ
鬻	弓弓冂
洙	氵朱Ｚ
墀	土尸牛
孥	女又子
疣	疒尢丶
茇	艹犮Ｂ
耪	耒旁方
芪	艹Ｃ七
愆	彳亍心
筮	工人
榫	木隹十
栀	木Ｆ
薅	艹女寸
萁	艹其Ｑ
蜞	虫其Ｑ
蛩	工几虫
罨	罒大乚
鳟	鱼酋寸
阍	门Ｃ七
龃	止凵且
莰	艹土欠
酽	酉亚丿
栲	木耂丂
氪	气古儿
崤	山乂冃
啁	口冂土
铋	钅心丿
碘	石冂八
觚	用瓜
毽	毛彐干
捌	扌另刂
樾	木走戈
瘢	疒舟殳
茌	艹亻士
鹚	首幺鸟
骶	骨Ｃ七
菏	落可Ｈ
糁	米厶彡
穑	禾十囗
溏	氵广口
刖	月刂Ｙ
嫜	女章Ｚ
螽	夂虫虫
缒	纟追辶
滹	氵虍丁
髋	骨宀见
攮	扌十ｒ
楂	木木一
戽	户斗Ｈ
铧	钅匕十
囝	囗子Ｎ
愍	巳攵心
坭	土尸匕
熵	火商Ｓ
澶	氵亠一
鲂	鱼方Ｆ
鞯	革艹子
橛	木厂欠
飧	夕食Ｓ
痈	疒用Ｙ
枞	木人人
殂	歹且Ｃ
冱	冫一彑
匏	大Ｓ包
蠼	虫目又
嵊	山禾丬
艉	舟尸毛
岙	丿大山
樗	木雨Ｓ
遄	山丆辶
舂	臼Ｃ
椟	木十头
尕	乃小Ｇ
柙	木甲Ｘ
伧	亻仓Ｃ
坻	土Ｃ七
瓠	大Ｓ瓜
镬	钅艹又
髡	髟一儿
薮	艹女攵
蔌	艹木欠
龉	止凵口
鹾	卜囗工
讣	讠卜Ｆ
皲	冖车皮
髁	骨日木
杲	日木Ｇ
芰	艹十又
椐	木尸古
橼	木彑豕
缯	纟丷日
鸹	舌鸟Ｇ
龋	止凵冂
莪	艹手戈
锞	钅日木
圹	土广Ｋ
黧	禾勹黑
隈	阝田ｒ
彘	彑矢比
暌	日癶大
餍	厂大食
赜	匚贝
筚	比十
泔	氵廿一
嘏	古尸又
疠	疒丆
鸬	卜尸鸟
檠	艹攵木
饧	饣Ｊ彳
醯	酉充皿
蚬	虫见Ｘ
蓖	艹白比
哏	口艮Ｇ
蹁	户冊
朐	月勹口
疋	乛止Ｓ
甑	丷日瓦
绂	纟犮Ｆ
铗	钅夫丷
髫	髟召Ｔ
螅	虫丿心
宄	宀九Ｇ
芎	艹弓Ｘ
摭	扌广灬
膣	月穴土
苷	艹廿一
骟	马户羽
圯	土巳Ｙ
棹	木卜十
枳	木口八
啭	口二
蔟	艹族矢
妫	女冫力
鍪	攵金
夤	夕穴一
牖	片户甫
觯	用十
棰	木千垂
盍	土厶皿
茭	艹亠父
耨	耒厂寸
鞣	革木
钡	钅贝Ｂ
礅	石高攵
苴	艹且Ｊ
熘	火刀田
硼	石月月
秫	禾木丶
铊	钅宀匕
柁	木宀匕
壅	亠丝土
飑	风包Ｂ
膈	月一冂
钪	钅亠几
箜	穴工
缡	纟文冂
醚	酉米辶
敉	米攵Ｍ
甯	宀心用
潍	氵纟隹
寤	宀爿口
肄	匕矢干
阈	门戈口
跏	加Ｊ
栊	木龙Ｌ
栌	木卜尸
涑	氵木口
脘	月宀元
酎	酉寸Ｚ
柒	氵七木
谵	讠言
鲳	鱼日日
茈	艹止匕
痱	疒非Ｆ
鬈	髟
蛳	虫一巾
秭	禾丿Ｓ
阏	门方人
捩	扌户大
镆	钅莫Ｍ
枇	木比Ｐ
枵	木口丂
氚	气川Ｃ
皴	厶夂皮
堀	土尸出
讴	讠匚乂
圊	囗青Ｑ
穰	禾衣口
蟮	虫羊口
笥	口
焐	火五口
菖	艹日日
绐	纟厶口
儋	亻言
邡	方阝Ｆ
蓼	艹羽彡
蒌	艹米女
圮	土己Ｐ
浠	氵乂巾
廨	广牛
怙	忄古Ｈ
闶	门亠几
瓿	立口瓦
诂	讠古Ｇ
粳	米丈日
鳓	鱼革力
漯	氵田小
眚	丿目
庑	广干乚
苎	萱一Ｎ
觳	士用殳
楗	木彐廴
徼	彳白攵
莨	艹丶艮
黥	黑高小
芴	艹勹彳
酰	酉儿
柽	木又土
钭	钅斗Ｔ
揿	扌钅欠
蓊	艹八羽
馑	饣廿
喾	学告Ｋ
僳	亻覀米
揎	扌宀一
挹	扌口巴
芏	艹土Ｄ
剀	山己刂
愦	忄贵Ｋ
曩	日衣口
袢	衤半Ｐ
酾	酉一冂
硒	石西Ｘ
曛	日千黑
俣	亻口大
笊	爪Ｚ
卮	ＦＺ
汊	氵又丶
郴	林阝Ｃ
雠	隹讠隹
鲷	鱼冂土
仂	亻力Ｌ
莴	艹口内
癍	疒王王
榧	木匚非
鹣	首兼鸟
蘖	艹追木
旆	族一巾
蕖	落匚木
桡	木戈儿
荪	艹子小
婺	攵女
妯	女由Ｚ
钣	钅反Ｂ
垆	土卜尸
沤	氵匚乂
屣	尸彳止
卺	乛水
嫠	未厂女
蘼	艹广非
坶	土母Ｍ
蘧	艹虍辶
镒	钅首皿
蕞	艹耳又
玢	王分Ｂ
厝	厂日
锆	钅告Ｇ
鬲	一口冂
詈	罒言Ｌ
箧	匚夫
铴	钅氵Ｊ
怃	忄干乚
浜	氵丘八
鳔	鱼覀示
缶	缶ＦＵ
藿	艹雨隹
蛑	虫厶牛
柰	木示Ｎ
鼗	Ｋ首又
蓥	营金Ｙ
欤	与欠Ｙ
钚	钅不Ｂ
蛞	虫舌Ｋ
娌	女里Ｌ
鲆	鱼干丷
癔	疒立心
鄣	章阝Ｚ
酢	酉乍Ｃ
骖	马厶彡
酲	酉口王
碓	石隹Ｄ
妗	女亽乛
麈	鹿比主
傧	亻穴丘
燔	火丿田
黻	业巾犮
缂	纟革Ｋ
鹩	大小鸟
碛	石贝
铱	钅衣Ｙ
塬	土厂小
韫	二卩皿
揸	扌木一
趵	勹丶
屙	尸阝可
猓	犭日木
檩	木亠示
谝	讠户冊
笸	匚口
蜣	虫乚
溽	氵厂寸
蜩	虫冂土
乇	丿七Ｔ
痦	疒五口
赀	止匕贝
萏	艹臼
偾	亻十贝
鄄	覀土阝
岘	山见Ｘ
揠	扌匚日
伛	亻匚乂
碚	石立口
阊	门日日
蕺	艹耳戈
孓	乛亅丶
镧	钅门木
锊	钅爫寸
铍	钅皮Ｐ
溱	氵禾
昝	夂卜日
胙	月乍Ｚ
瑷	王爱Ａ
邶	丬匕阝
坫	土占Ｄ
伲	亻尸匕
芑	艹己Ｑ
缬	纟吉页
硎	石一刂
镟	钅族止
糌	米卜日
隹	隹ＣＩ
坼	土斤丶
幞	巾业丶
戢	口耳戈
崃	山未丷
髀	骨卑Ｂ
忭	忄亠卜
箪	丷十
瞢	艹罒目
筌	全Ｑ
菽	艹小又
荨	艹彐寸
郅	一土阝
锛	钅大廾
笾	力辶
篪	几
辏	车大
癜	疒尸殳
钒	钅几丶
哕	口山夕
敫	白方攵
廑	广廿
鲢	鱼车辶
仳	亻比Ｐ
厍	厂车Ｓ
砷	石日丨
蓍	艹耂日
鳎	鱼日羽
圬	土二Ｓ
欷	乂欠
碹	石宀一
甏	吉彡瓦
檗	尸辛木
豉	一首又
淦	氵金Ｇ
磙	石衣八
苣	艹匚尸
艿	艹乃Ｎ
颞	耳又页
嗍	口丷月
胝	月Ｃ七
槠	木讠者
诼	讠豕丶
诹	讠耳又
麸	夂夫
蛱	虫夫丷
鞫	革勹言
锂	钅里Ｌ
荞	艹丿刂
轫	车刀丶
椹	木其乚
郾	匚日阝
楱	木大
迨	厶口辶
氘	气刂Ｄ
槲	木斗
耩	耒井冂
熳	火日又
缌	纟田心
恂	忄勹日
铟	钅囗大
卣	卜囗尸
唣	口白七
苁	艹人人
裉	衤艮Ｋ
瘰	疒田小
泺	氵Ｃ小
锘	钅艹口
璩	王虍豕
薹	艹吉土
阌	门受Ｗ
堙	土覀土
茺	艹充儿
砩	石弓刂
蓠	艹文冂
啉	口林Ｌ
黾	口日乚
诒	讠厶口
唑	口人土
砗	石车Ｃ
羝	Ｃ七
顸	干页Ｈ
刳	大Ｓ刂
杩	木马Ｍ
俳	亻非Ｐ
慊	忄首兼
缫	纟巛木
茼	艹冂一
狺	犭言Ｙ
缍	纟千垂
圪	土乙
麇	鹿比禾
悝	忄里Ｋ
尥	尢勹丶
狨	犭戈
铯	钅巴
嗾	口族矢
胗	月人彡
痤	疒人土
隳	阝
镢	钅厂欠
鹋	艹田鸟
槭	木戊卜
畹	田宀
嵛	山亼前
饫	饣丿大
蘩	艹小
赓	广彐贝
绲	纟日比
翮	一冂羽
郐	人云阝
缧	纟田小
酹	酉爫寸
唛	口夂
颟	艹两页
蠓	虫营豕
眄	目一
葚	艹其乚
腧	月亼前
溲	氵叟Ｓ
溻	氵日羽
踬	贝
怍	忄乍Ｚ
畚	厶大田
嬖	尸辛女
糍	米首幺
旰	日干Ｇ
鞲	革井冂
涫	氵宀官
颃	亠几页
荭	艹纟工
嵴	山Ｋ月
垲	土山己
呒	口干乚
胼	月首廾
芡	艹欠Ｑ
朊	月元Ｒ
馓	饣攵
跣	儿
刈	乂刂Ｙ
萸	艹臼人
龠	亼口冊
帻	巾贝
瘳	疒羽彡
疸	疒日一
磴	石癶首
陔	阝亥Ｇ
醢	酉皿
踺	彐廴
蠲	首皿勹
蛸	虫冃
硖	石夫丷
鲞	鱼Ｘ
蚴	虫幺力
镲	钅宀示
戥	日戈
葑	艹圭寸
篌	亻矢
栝	木舌Ｇ
耧	耒米女
峁	山Ｇ卩
堋	土月月
芘	艹比Ｐ
謦	声殳言
鸲	勹口鸟
颡	又木页
鄞	廿阝
嗌	口首皿
踔	卜十
疔	疒丁Ｄ
铒	钅耳Ｅ
桄	木儿
屦	尸彳女
侉	亻大Ｓ
粝	米厂
瘘	疒米女
痧	疒氵少
绨	纟丷弓
葸	艹田心
薏	艹立心
仉	亻几Ｚ
廛	广里土
簟	覀十
裰	衤又又
畈	田反Ｆ
鲋	鱼亻寸
舻	舟卜尸
皤	白丿田
嗪	口禾
凇	冫八厶
谇	讠亠十
掭	扌一
燠	火白大
虿	丆虫
莼	艹纟七
毳	毛毛毛
簦	癶首
蹀	世木
胍	月瓜Ｇ
缣	纟首兼
枧	木见Ｊ
鲮	鱼土夂
陧	阝日土
泮	氵半Ｐ
梃	木壬廴
醑	酉乛冃
勖	日目力
谖	讠爫又
谳	讠大丶
铘	钅一阝
轭	车厂
酐	酉干Ｇ
庋	广十又
僬	亻焦Ｊ
贶	贝口儿
醅	酉立口
蝤	虫酋Ｑ
垧	土白口
锬	钅火火
趑	走冫欠
菹	落且Ｚ
龀	止凵匕
藁	艹高木
诖	讠圭Ｇ
匦	匚车九
笕	见Ｊ
硷	石亼兴
锩	钅
垅	土龙Ｌ
肭	月内Ｎ
陴	阝卑Ｐ
吣	口心Ｑ
醛	酉艹全
蒴	艹山月
邾	朱阝Ｚ
鳊	鱼户冊
鸸	丆皿鸟
桴	木爫子
搿	亼手
胲	月亥Ｈ
剞	大可刂
鬏	髟禾火
芤	艹子乚
嵝	山米女
艋	舟子皿
悛	忄厶夂
疝	疒山Ｓ
柝	木斤丶
鲔	鱼冃
拶	扌巛夕
黹	业丷巾
舯	舟口丨
箅	田丌
榇	木亲Ｃ
菰	艹子瓜
煳	火古月
劂	厂丷刂
蚵	虫可Ｈ
礞	石营豕
钼	钅目Ｍ
嬲	田力力
劬	勹口力
肽	月大丶
洧	氵冃
硪	石手戈
葙	艹木目
埸	土日勹
躜	贝
鬯	乂凵匕
鲱	鱼非Ｆ
砜	石风Ｆ
呋	口夫Ｆ
莩	艹爫子
鹨	羽彡鸟
墁	土日又
觫	用木
辋	车冂首
隰	阝日灬
獯	犭千黑
佾	亻八冃
媵	月女
趱	走
髌	骨穴丘
埕	土口王
谠	讠尚儿
碲	石旁巾
垤	土一土
唪	口干
绀	纟廿一
铪	钅亼口
洚	氵夂舛
嫘	女田小
楝	木木柬
甍	艹罒瓦
髂	骨宀各
磲	石匚木
绱	纟尚Ｓ
潲	氵冃
鲥	鱼日寸
铵	钅安Ａ
舨	舟反Ｂ
羼	尸羊羊
笪	日一
酚	酉分Ｆ
刿	山夕刂
曷	日勹乚
溷	氵囗豕
骱	骨人刂
胬	女又内
俜	亻由丂
銎	工几金
诎	讠出Ｑ
枘	木内Ｒ
镡	钅覀十
粜	出米Ｔ
浯	氵五口
绁	纟世Ｘ
崦	山大乚
劓	丿丌刂
蓣	艹丁页
菝	艹扌犮
鐾	尸辛金
蛏	虫又土
汆	丿丶水
甙	弋廿一
蒽	艹囗心
绋	纟弓刂
岣	山勹口
崮	山囗古
岵	山古Ｈ
掎	扌大可
挢	扌丿刂
讵	讠匚尸
窭	穴米女
赉	未丷贝
掊	扌立口
芟	艹殳Ｓ
毹	亼前毛
锶	钅田心
慝	匚艹心
氽	人水Ｔ
芄	艹九丶
怿	忄又干
鹆	谷鸟Ｙ
瘵	疒祭示
啶	口宀止
蔸	艹白儿
砘	石七凵
罟	罒古Ｇ
蚶	虫廿一
鲎	学鱼Ｈ
锾	钅爫又
湔	氵首前
搛	扌首兼
柃	木亽
逯	彐水辶
亓	二刂Ｑ
屺	山己Ｑ
郄	乂阝
檎	木人冂
毵	厶彡毛
渖	氵宀丨
肟	月二Ｓ
饩	饣气Ｘ
躞	火又
谮	讠旡日
酯	酉匕日
塍	月土
擐	扌罒ｒ
蠖	虫艹又
觖	用夬
跬	圭Ｋ
氇	毛鱼日
嘧	口宀山
蝻	虫Ｍ首
湓	氵分皿
氆	毛首业
庥	广亻木
嵫	山首幺
撙	扌酋寸
褊	衤户冊
篼	白儿
鳜	鱼厂欠
劢	丆力
蛴	虫文刂
汔	氵乙
骀	马厶口
醣	酉广口
腽	月日皿
舾	舟西Ｘ
仡	亻乙
莸	艹犭尢
黼	业巾甫
袼	衤各Ｇ
缑	纟尸矢
笱	勹口
袷	衤亼口
肼	月井Ｊ
僦	亻尢丶
蒉	艹贵Ｋ
阃	门囗木
臁	月广兼
倮	亻日木
芈	丨一干
杪	木少Ｍ
蠛	虫艹戊
蛲	虫戈儿
硗	石戈儿
跫	工几足
荽	艹爫女
渫	氵世木
崾	山覀女
瘗	疒夫土
箦	贝
舳	舟由Ｚ
黪	黑厶彡
锸	钅千臼
瓞	瓜失Ｄ
滏	氵父首
戆	章夂心
遘	井冂辶
簋	艮皿
鹪	焦鸟Ｊ
扃	户冂口
篥	覀木
鞔	革儿
浼	氵儿
庀	广匕Ｐ
肷	月欠Ｑ
鲭	鱼青Ｑ
埽	土彐巾
钽	钅日一
酴	酉余Ｔ
溆	氵余又
钸	钅巾
髑	骨罒勹
鳆	鱼夂
黉	学八
逭	宀官辶
浍	氵人云
裥	衤门日
榘	矢匚木
犋	牜且八
钌	钅乛亅
躐	巛鼠
砻	龙石Ｌ
苤	艹不一
榀	木口口
钋	钅卜Ｐ
綮	户攵小
胂	月日丨
锼	钅叟Ｓ
炱	厶口火
疃	田立里
煺	火艮辶
鼯	臼鼠口
籼	米山Ｘ
芗	艹丝丿
儇	亻罒ｒ
砟	石乍Ｚ
肫	月七凵
秕	禾比Ｂ
踣	立口
帱	巾丰寸
氡	气夂冫
垌	土冂一
佴	亻耳Ｅ
糇	米尸矢
肀	彐丨Ｙ
澌	氵其斤
耜	耒官Ｓ
龆	止凵召
禊	礻刀大
溴	氵丿大
氩	气亚Ｙ
吲	口弓丨
岜	山巴Ｂ
惝	忄尚Ｃ
蝽	虫日
腠	月大
徂	彳且Ｃ
硐	石冂一
镉	钅一冂
虼	虫乙
烀	火丿丁
蟪	虫士心
桷	木用
坜	土厂力
瞵	目米舛
簏	鹿比
镘	钅日又
擗	扌尸辛
筇	工阝
畋	田攵Ｔ
葶	艹亮丁
沲	氵也
穸	穴夕Ｘ
眢	夕目
搌	扌尸ｒ
埴	土十且
陬	阝耳又
砹	石艹乂
畀	田丌Ｂ
鹁	十子鸟
觇	占见Ｃ
瘅	疒丷十
菪	萱石Ｄ
铞	钅口巾
锇	钅手戈
钫	钅方Ｆ
砉	丰石Ｈ
锪	钅勹心
哜	口文刂
锔	钅尸
膦	月米舛
螨	虫艹两
茆	艹Ｇ卩
埤	土卑Ｂ
铈	钅亠巾
裼	衤日勹
迕	午辶Ｗ
氙	气山Ｘ
楦	木宀一
蛘	虫羊Ｙ
镱	钅立心
霪	雨氵壬
畛	田人彡
碡	石母
缵	纟贝
锿	钅衣口
襞	尸辛衣
髟	髟ＢＯ
蒇	艹戊贝
冁	丷十ｒ
籴	丿丶米
揲	扌世木
镦	钅高攵
苊	艹厂
疳	疒廿一
茛	艹艮Ｇ
鳇	鱼白王
攉	扌雨隹
虮	虫几Ｊ
镓	钅宀豕
噍	口焦Ｊ
弪	弓又工
胩	月卜下
罱	罒Ｍ首
苈	艹厂力
蠊	虫广兼
埝	土亽心
钕	钅女Ｎ
羟	又工
羰	山火
轺	车召Ｙ
舴	舟乍Ｚ
潴	氵犭者
萆	艹卑Ｂ
晡	日甫Ｂ
爨	臼冂火
榱	木衣口
铥	钅千厶
鸫	七小鸟
胨	月七小
罘	罒不Ｆ
槔	木白十
鹱	鸟艹又
墼	車殳土
骒	马日木
悃	忄囗木
漤	氵林女
稂	禾丶艮
诔	讠耒Ｌ
鲡	鱼一冂
疬	疒厂力
钔	钅门Ｍ
淠	氵田丌
裒	衣臼Ｐ
缲	纟口木
薷	艹雨皿
埏	土丿廴
谂	讠亽心
鲦	鱼夂朩
莛	艹壬廴
榍	木尸冃
髹	髟亻木
砑	石一才
垸	土宀元
帙	巾失Ｚ
窀	穴七凵
浞	氵足Ｚ
褙	衤匕冃
苄	艹亠卜
骣	马尸子
舡	舟工Ｃ
岽	山七小
赙	贝甫寸
漶	氵口心
跽	己心
疖	疒卩Ｊ
腈	月青Ｊ
桕	木臼Ｊ
桊	木Ｊ
埒	土爫寸
镅	钅尸目
镎	钅亼手
哌	口ｒ
郫	卑阝Ｐ
锖	钅青Ｑ
畎	田大丶
悫	士冖心
颥	雨皿页
唼	口立女
钐	钅彡Ｓ
矧	矢弓丨
牾	牜五口
鹇	门木鸟
殪	歹士首
鳙	鱼广冃
饔	亠丝食
籀	扌田
鄹	耳乑阝
坌	分土Ｂ
荸	艹十子
艚	舟西日
觌	十头见
铫	钅ＫＫ
鲼	鱼十贝
澉	氵乛攵
哿	加可Ｇ
瘊	疒亻矢
骺	骨Ｆ口
豇	一首工
筘	扌口
硇	石白乂
聍	耳宁Ｎ
蜱	虫卑Ｐ
丿	丿ＰＥ
氍	目隹毛
酞	酉大丶
钍	钅土Ｔ
沩	氵冫力
洫	氵丿皿
珧	王ＫＫ
舁	臼廾Ｙ
瀹	氵亼冊
粢	冫欠米
鲅	鱼犮Ｂ
鞴	革用
窆	穴丿之
瘛	疒丰心
镄	钅弓贝
祓	礻犮Ｆ
恝	丰刀心
瘕	疒尸又
戋	一戈Ｊ
鲒	鱼吉Ｊ
醵	酉虍豕
瘼	疒莫Ｍ
铌	钅尸匕
脬	月爫子
葜	艹丰大
椠	车斤木
瞍	目叟Ｓ
羧	厶夂
粞	米西Ｘ
蓰	艹彳止
窬	穴亼前
哳	口扌斤
轵	车口八
忮	忄十又
埯	土大乚
聱	敖耳Ａ
礤	石艹示
搋	扌几
憝	高攵心
钆	钅乚Ｇ
艽	艹九Ｊ
鳘	攵鱼
恧	丆皿心
襻	衤木手
氕	气丿Ｐ
镨	钅首日
铷	钅女口
洳	氵女口
蟓	虫象Ｘ
鸺	亻木鸟
铕	钅冃
驵	马且Ｚ
迮	乍辶Ｚ
廒	广敖Ａ
濞	氵丿丌
嶝	山癶首
耵	耳丁Ｄ
蹯	丿田
篚	匚非
嚆	口艹高
劐	艹又刂
鲚	鱼文刂
鲣	鱼又土
趼	一廾
赆	贝尺冫
爝	火爫寸
钶	钅可Ｋ
鳢	鱼日首
荬	艹乛头
镤	钅业丶
桤	木山己
筲	冃
堍	土兔Ｔ
箨	扌干
蕹	艹丿隹
钇	钅乙Ｙ
罾	罒丷日
橥	犭者木
鲻	鱼巛田
阼	阝乍Ｚ
揞	扌立日
庳	广卑Ｂ
馇	饣木一
怊	忄召Ｃ
脞	月人土
埭	土彐水
塥	土一冂
绠	纟丈日
蕻	艹厶八
鲩	鱼宀元
癀	疒八
洎	氵丿目
礓	石一一
捃	扌彐口
锎	钅门一
轹	车Ｃ小
跞	Ｃ小
瞀	攵目
猸	犭尸目
鹛	尸目鸟
脒	月米Ｍ
耱	耒广石
衄	丿皿丑
甓	尸辛瓦
锓	钅彐又
脎	月乂朩
滠	氵耳又
鲐	鱼厶口
萜	艹巾占
砼	石人工
涠	氵囗二
甾	巛田Ｚ
痄	疒乍Ｚ
浈	氵卜贝
瘃	疒豕丶
舭	舟比Ｂ
螬	虫西日
躔	广土
枨	木长Ｃ
眵	目夕夕
镩	钅穴丨
垡	亻戈土
稃	禾爫子
郛	爫子阝
酤	酉古Ｇ
崞	山高子
蜾	虫日木
捍	扌日干
谫	讠首刀
眍	目匚乂
癃	疒阝
毪	毛厶牛
仫	亻丿厶
垴	土文凵
筢	扌巴
锫	钅立口
螵	虫覀示
岍	山一廾
阢	阝一儿
菥	艹木斤
鼷	臼鼠大
薤	艹歹一
舣	舟丶乂
著	艹者Ｚ
腙	月宀示
蒡	艹旁方
鹎	卑鸟Ｂ
滗	氵毛
缏	纟亻丈
醭	酉业丶
猹	犭木一
瘥	疒工
膪	月旁口
阽	阝占Ｄ
簖	乚斤
牿	牜告Ｇ
馘	首目戈
撖	扌乛攵
缋	纟贵Ｈ
牮	代牛Ｊ
铼	钅未丷
铹	钅营力
泐	氵阝力
墚	土刀木
镥	钅鱼日
苠	艹巳七
脲	月尸水
蒎	落ｒ
犏	牜户冊
钷	钅匚口
劁	焦刂Ｑ
鼽	丿丌九
磉	石又木
鲺	鱼乙丿
贳	世贝Ｓ
摅	扌虍心
耥	耒尚Ｔ
螗	虫广口
箢	夕
軎	車口Ｗ
莶	艹亼兴
痃	疒玄Ｘ
痖	疒亚Ｙ
疰	疒主Ｚ
碥	石户冊
瘭	疒覀示
傺	亻祭示
鼢	臼鼠分
瀵	氵米八
艴	弓刂巴
戤	乃皿戈
筻	丈日
觏	井冂见
鲴	鱼囗古
轷	车丿丁
耠	耒亼口
茳	落工Ｊ
喹	口大圭
醌	酉日比
蒗	落丶艮
铑	钅耂匕
耢	耒营力
蔹	艹兴攵
稆	禾口口
攴	卜又Ｐ
苘	艹冂口
赇	贝氺丶
辁	车全Ｑ
赕	贝火火
铽	钅弋心
猃	犭亼兴
糈	米乛冃
酏	酉也Ｙ
茚	艹Ｅ卩
齄	丿丌一
绗	纟彳亍
荮	艹纟寸
夼	大川Ｋ
螋	虫叟Ｓ
耖	耒少Ｃ
蒈	艹比白
鲕	鱼丆皿
禚	礻灬
鳋	鱼又虫
