的	的 的话 的确 的士 的哥 的的确确
了	了 了解 了不起 了不得 了然 了结
一	一 一个 一下 一样 一起 一直
是	是 是不是 是因为 是否 是从 是非
不	不 不是 不过 不会 不能 不要
我	我 我们 我会 我家 我爱你 我俩
这	这 这个 这么 这样 这里 这些
在	在 在家 在意 在场 在外 在乎
有	有 有些 有点 有人 有着 有没有
你	你 你们 你好 你家 你们好 你老
个	个 个人 个子 个头 个个 个性
人	人 人家 人生 人类 人们 人群
来	来 来到 来说 来自 来看 来不及
他	他 他们 他家 他人 他俩 他用
着	着 着急 着实 着手 着眼 着想
就	就 就是 就算 就要 就让 就行了
说	说 说道 说完 说话 说出 说不定
说	说 说道 说完 说话 说出 说不定
到	到 到底 到时候 到处 到来 到达
么	么 么妹儿
上	上 上面 上课 上去 上学 上班
道	道 道歉 道理 道路 道士 道长
看	看 看着 看到 看看 看见 看来
也	也 也许 也好 也就是说 也罢 也許
那	那 那个 那么 那些 那里 那种
子	子 子弹 子女 子弟 子孙 子路
大	大 大家 大学 大哥 大概 大声
没	没 没有 没事 没想到 没什么 没错
好	好 好像 好好 好奇 好看 好多
下	下 下来 下去 下午 下面 下次
时	时 时候 时间 时代 时光 时不时
还	还 还是 还有 还要 还好 还给
去	去 去世 去年 去过 去往 去路
出	出 出来 出现 出去 出门 出手
自	自 自己 自然 自从 自信 自行车
小	小 小子 小时 小说 小姐 小心
过	过 过来 过去 过后 过程 过于
要	要 要是 要求 要不是 要说 要不然
然	然 然后 然而 然後 然则 然后背
里	里 里面 里边 里头 里屋 里里外外
天	天 天空 天天 天地 天气 天下
后	后 后面 后来 后悔 后退 后背
都	都 都市 都还没 都行 都还不 都城
想	想 想到 想要 想着 想起 想法
会	会 会议室 会议 会儿 会长 会员
会	会 会议室 会议 会儿 会长 会员
可	可 可以 可是 可能 可惜 可爱
能	能 能够 能力 能量 能否 能源
起	起 起来 起身 起床 起点 起码
己	己 己方 己任 己身 己巳 己所不欲
心	心 心里 心中 心情 心想 心思
以	以 以后 以为 以前 以及 以来
为	为 为什么 为了 为何 为难 为此
对	对 对于 对方 对面 对不起 对手
中	中 中国 中间 中午 中年人 中学
得	得 得到 得意 得罪 得知 得出
地	地 地方 地上 地球 地面 地下
手	手 手机 手中 手里 手上 手指
什	什 什么 什么样 什么游戏 什麼 什么世道
开	开 开始 开口 开心 开玩笑 开学
她	她 她们 她家 她俩 她們 她倆
头	头 头发 头上 头顶 头脑 头疼
家	家 家里 家伙 家族 家庭 家人
生	生 生活 生命 生气 生意 生物
身	身 身体 身上 身边 身后 身影
只	只 只是 只有 只能 只要 只见
样	样 样子 样貌 样式 样样 样儿
老	老 老师 老板 老头 老子 老人
面	面 面前 面对 面子 面试 面容
和	和 和尚 和谐 和平 和蔼 和善
点	点 点头 点点头 点击 点燃 点点
多	多 多少 多年 多么 多久 多少钱
啊	啊 啊啊啊 啊呀 啊哈 啊哟 啊呀呀
事	事 事情 事儿 事实 事件 事物
现	现 现在 现实 现场 现代 现象
知	知 知道 知识 知名 知不知道 知觉
很	很 很多 很快 很大 很少 很小
话	话 话题 话语 话音刚落 话音 话筒
而	而 而且 而是 而已 而后 而言
眼	眼 眼睛 眼前 眼神 眼中 眼泪
走	走 走进 走出 走向 走上 走来
之	之 之后 之前 之中 之间 之一
回	回 回来 回到 回家 回答 回去
些	些 些许 些小 些微 些须 些许端
前	前 前面 前世 前方 前辈 前来
学	学 学校 学生 学习 学院 学会
发	发 发现 发生 发出 发展 发现自己
打	打 打开 打算 打电话 打量 打断
吧	吧 吧台 吧唧 吧嗒 吧哒 吧檯
给	给 给予 给出 给钱 给你个 给面子
给	给 给予 给出 给钱 给你个 给面子
经	经 经过 经常 经历 经理 经验
笑	笑 笑容 笑了笑 笑声 笑笑 笑意
女	女 女孩 女人 女生 女子 女儿
把	把 把手 把头 把握 把门 把玩
间	间 间隔 间接 间隙 间谍 间断
声	声 声音 声响 声道 声望 声明
但	但 但是 但愿 但他却 但凡 但丁
情	情 情况 情绪 情侣 情节 情景
意	意 意思 意识 意外 意义 意见
无	无 无奈 无法 无比 无数 无聊
被	被 被子 被窝 被动 被迫 被骗
让	让 让开 让给 让你在 让出 让步
两	两 两个 两年 两天 两位 两万
气	气 气息 气氛 气质 气势 气愤
真	真 真的 真是 真正 真实 真心
年	年 年轻 年轻人 年纪 年龄 年代
已	已 已经 已然 已有 已成 已知
见	见 见到 见面 见状 见识 见鬼
见	见 见到 见面 见状 见识 见鬼
所	所 所以 所有 所有人 所谓 所在
如	如 如果 如此 如何 如同 如今
又	又 又称 又名 又惊又喜 又会有 又哭又笑
怎	怎 怎么 怎么样 怎么办 怎么回事 怎样
几	几 几个 几天 几乎 几年 几分
于	于 于是 于是乎 于洋 于心不忍 于事无补
方	方 方向 方式 方法 方面 方便
成	成 成为 成绩 成功 成熟 成长
问	问 问道 问题 问问 问候 问话
力	力 力量 力气 力道 力度 力不从心
当	当 当然 当时 当初 当年 当中
觉	觉 觉得 觉醒 觉着 觉悟 觉察到
明	明 明白 明天 明显 明明 明星
张	张 张扬 张开 张大 张嘴 张老师
边	边 边上 边缘 边境 边框 边界
李	李 李家 李子 李老师 李强 李成
林	林 林子 林家 林木 林海 林立
用	用 用力 用来 用心 用尽 用处
感	感 感觉 感到 感受 感情 感谢
才	才 才能 才刚 才华 才子 才艺
从	从 从小 从来 从此 从未 从来不
听	听 听到 听见 听说 听话 听不懂
长	长 长大 长发 长相 长长的 长时间
长	长 长大 长发 长相 长长的 长时间
口	口 口气 口袋 口中 口水 口子
动	动 动作 动手 动物 动静 动力
候	候 候车室 候选人 候车厅 候车 候机
正	正 正在 正是 正好 正常 正式
王	王 王子 王明 王老师 王八蛋 王者
定	定 定格 定位 定义 定下 定睛一看
再	再 再次 再说 再也 再见 再有
脸	脸 脸上 脸色 脸庞 脸颊 脸蛋
白	白 白色 白天 白皙 白衣 白眼
次	次 次数 次日 次次 次要 次郎
进	进 进入 进来 进去 进行 进门
直	直 直接 直到 直奔 直播 直视
高	高 高兴 高中 高考 高手 高三
三	三 三个 三年 三天 三分 三十
最	最 最后 最好 最近 最终 最大
门	门 门口 门外 门前 门卫 门上
刚	刚 刚才 刚刚 刚好 刚刚开始 刚出生
同	同 同学 同时 同样 同学们 同意
实	实 实在 实力 实现 实验 实际上
别	别 别人 别的 别说 别墅 别提
本	本 本来 本书 本事 本身 本人
神	神 神秘 神色 神情 神奇 神仙
儿	儿 儿子 儿女 儿时 儿童 儿媳妇
完	完 完全 完成 完美 完毕 完整
做	做 做出 做到 做好 做梦 做饭
接	接 接着 接受 接下来 接过 接触
少	少 少年 少女 少爷 少妇 少不了
行	行 行李 行动 行为 行人 行走
行	行 行李 行动 行为 行人 行走
向	向 向着 向前 向上 向往 向前走
分	分 分钟 分别 分手 分开 分为
吗	吗 吗啡 吗啉
种	种 种种 种子 种族 种植 种地
种	种 种种 种子 种族 种植 种地
因	因 因为 因此 因素 因果 因而
车	车 车子 车上 车门 车里 车厢
车	车 车子 车上 车门 车里 车厢
十	十 十分 十年 十分钟 十足 十几年
像	像 像是 像样 像素 像不像 像模像样
快	快 快速 快点 快要 快乐 快步
其	其 其实 其他 其中 其他人 其它
其	其 其实 其他 其中 其他人 其它
跟	跟 跟着 跟前 跟上 跟随 跟我来
等	等 等等 等待 等到 等级 等于
吃	吃 吃饭 吃惊 吃完饭 吃饱 吃亏
住	住 住院 住处 住手 住宿 住校
此	此 此时 此刻 此人 此书 此时此刻
却	却 却是 却说 却不曾 却没能 却之不恭
果	果 果然 果断 果不其然 果实 果子
男	男 男人 男子 男生 男孩 男朋友
呢	呢 呢喃 呢子大衣 呢子 呢大衣 呢绒
光	光 光芒 光头 光线 光明 光亮
色	色 色彩 色狼 色眯眯 色泽 色迷迷
色	色 色彩 色狼 色眯眯 色泽 色迷迷
外	外 外面 外号 外表 外套 外人
放	放 放在 放心 放下 放弃 放学
哥	哥 哥哥 哥们 哥们儿 哥俩 哥儿
叫	叫 叫做 叫声 叫醒 叫住 叫喊
作	作 作为 作者 作业 作品 作用
死	死 死亡 死去 死党 死神 死者
便	便 便是 便宜 便利店 便利 便当
便	便 便是 便宜 便利店 便利 便当
机	机 机会 机械 机场 机器 机器人
将	将 将来 将近 将军 将要 将门
二	二 二人 二楼 二代 二十 二哥
法	法 法术 法律 法力 法则 法师
找	找 找到 找死 找出 找回 找寻
名	名 名字 名叫 名为 名片 名声
东	东 东西 东方 东北 东海 东边
体	体 体内 体质 体会 体力 体验
全	全 全部 全身 全都 全班 全国
太	太 太阳 太好了 太久 太小 太极
应	应 应该 应聘 应付 应声 应对
电	电 电话 电脑 电影 电视 电梯
带	带 带来 带上 带走 带到 带你去
风	风 风景 风格 风衣 风水 风雨
师	师 师傅 师父 师兄 师姐 师妹
位	位 位置 位于 位子 位列 位居
陈	陈 陈家 陈老师 陈旧 陈云 陈先生
比	比 比较 比如 比赛 比起 比如说
算	算 算是 算了 算了吧 算不上 算命
安	安 安静 安排 安慰 安全 安心
字	字 字数 字迹 字体 字样 字眼
孩	孩 孩子 孩童 孩儿 孩子气 孩子王
主	主 主人 主要 主任 主角 主动
理	理 理解 理由 理会 理想 理论
叶	叶 叶子 叶家 叶城 叶落 叶先生
叶	叶 叶子 叶家 叶城 叶落 叶先生
公	公 公司 公交车 公园 公子 公主
先	先 先生 先是 先前 先回去 先天
飞	飞 飞机 飞快 飞扬 飞速 飞奔
水	水 水平 水晶 水果 水面 水中
今	今 今天 今年 今晚 今日 今后
拿	拿 拿出 拿到 拿来 拿下 拿走
相	相 相信 相当 相对 相互 相比
轻	轻 轻轻 轻松 轻声 轻易 轻轻地
更	更 更加 更是 更新 更好 更何况
钱	钱 钱包 钱财 钱币 钱小豪 钱袋
黑	黑 黑色 黑暗 黑衣人 黑衣 黑影
美	美 美女 美丽 美好 美国 美的
西	西 西装 西服 西瓜 西方 西门
第	第 第一次 第一 第二天 第一个 第一天
重	重 重要 重新 重生 重点 重复
重	重 重要 重新 重生 重点 重复
思	思 思考 思想 思绪 思索 思维
并	并 并且 并非 并未 并不知道 并不多
龙	龙 龙哥 龙阳 龙飞 龙头 龙家
难	难 难道 难以 难受 难得 难过
清	清 清楚 清晰 清醒 清晨 清秀
者	者 者阴山 者奈
离	离 离开 离去 离婚 离家 离别
变	变 变得 变成 变化 变态 变异
世	世 世界 世间 世上 世纪 世家
刘	刘 刘海 刘老师 刘家 刘备 刘安
路	路 路上 路边 路过 路人 路灯
关	关 关系 关于 关心 关注 关上
始	始 始终 始祖 始作俑者 始料未及 始终保持
空	空 空间 空气 空中 空调 空姐
何	何 何时 何况 何必 何处 何等
周	周 周围 周末 周边 周易 周天
坐	坐 坐在 坐下 坐车 坐落 坐坐
妈	妈 妈妈 妈呀 妈咪 妈祖 妈祖庙
常	常 常常 常人 常年 常见 常识
文	文 文化 文字 文明 文件 文学
音	音 音乐 音响 音量 音乐学院 音符
哈	哈 哈哈 哈哈哈 哈哈哈哈 哈哈大笑 哈欠
转	转 转身 转过 转头 转过身 转移
该	该 该死 该是 该不该 该换 该轮
强	强 强大 强烈 强者 强化 强行
强	强 强大 强烈 强者 强化 强行
场	场 场景 场面 场子 场地 场所
信	信 信息 信心 信任 信仰 信不信
亲	亲 亲自 亲人 亲戚 亲爱 亲切
早	早 早就 早上 早已 早餐 早点
处	处 处理 处于 处在 处处 处境
数	数 数字 数学 数据 数量 数学老师
任	任 任务 任何 任何人 任由 任性
校	校 校长 校园 校花 校服 校门口
校	校 校长 校园 校花 校服 校门口
马	马 马上 马路 马尾 马路上 马尾辫
入	入 入学 入侵 入口 入睡 入门
望	望 望去 望了望 望远镜 望望 望见
许	许 许多 许久 许诺 许许多多 许天
国	国 国家 国内 国际 国外 国人
表	表 表情 表现 表示 表面 表白
姐	姐 姐姐 姐妹 姐夫 姐弟 姐弟俩
虽	虽 虽然 虽说 虽则 虽败犹荣 虽死犹荣
满	满 满脸 满意 满足 满满的 满头
随	随 随着 随后 随便 随即 随意
干	干 干嘛 干什么 干净 干脆 干活
竟	竟 竟然 竟是 竟敢 竟自 竟未
加	加 加上 加入 加油 加快 加速
原	原 原来 原因 原本 原地 原谅
微	微 微微 微笑 微微一笑 微弱 微风
突	突 突然 突破 突如其来 突兀 突出
月	月 月光 月亮 月票 月儿 月份
紧	紧 紧张 紧紧 紧接着 紧闭 紧握
内	内 内心 内容 内部 内力 内裤
连	连 连忙 连续 连连 连衣裙 连接
万	万 万一 万物 万分 万万 万年
万	万 万一 万物 万分 万万 万年
哪	哪 哪里 哪个 哪怕 哪儿 哪位
活	活 活动 活着 活下去 活泼 活跃
站	站 站住 站立 站台 站稳 站点
平	平 平时 平静 平常 平凡 平淡
房	房 房间 房子 房门 房租 房东
四	四 四个 四周 四处 四年 四大
谁	谁 谁知 谁家 谁又能 谁谁谁 谁他妈
云	云 云天 云海 云彩 云朵 云层
爷	爷 爷爷 爷爷奶奶 爷们 爷俩 爷孙
红	红 红色 红包 红着脸 红光 红毛
红	红 红色 红包 红着脸 红光 红毛
花	花 花钱 花痴 花园 花费 花朵
阳	阳 阳光 阳台 阳光明媚 阳子 阳阳
新	新 新生 新书 新闻 新人 新鲜
书	书 书包 书友 书籍 书本 书房
静	静 静静的 静静地 静静 静止 静悄悄
目	目 目光 目标 目前 目的 目瞪口呆
解	解 解释 解决 解开 解脱 解除
解	解 解释 解决 解开 解脱 解除
远	远 远处 远远 远方 远去 远离
通	通 通过 通知 通红 通道 通知书
服	服 服务员 服务 服装 服务生 服用
记	记 记得 记忆 记住 记录 记者
受	受 受到 受伤 受不了 受过 受欢迎
慢	慢 慢慢 慢悠悠 慢点 慢吞吞 慢慢来
反	反 反应 反正 反而 反抗 反驳
杨	杨 杨树 杨柳 杨家 杨锐 杨成
班	班 班主任 班级 班长 班里 班上
似	似 似乎 似的 似笑非笑 似曾相识 似地
似	似 似乎 似的 似笑非笑 似曾相识 似地
山	山 山上 山洞 山里 山顶 山下
部	部 部队 部分 部门 部长 部位
跑	跑 跑车 跑过来 跑步 跑出去 跑掉
认	认 认识 认为 认真 认出 认可
倒	倒 倒霉 倒下 倒地 倒数 倒退
越	越 越来越 越发 越是 越来越近 越过
且	且 且不说 且说 且慢 且不论 且战且退
且	且 且不说 且说 且慢 且不论 且战且退
海	海 海洋 海边 海水 海里 海面
晚	晚 晚上 晚饭 晚自习 晚餐 晚安
惊	惊 惊讶 惊喜 惊恐 惊醒 惊呆
工	工 工作 工资 工厂 工地 工作人员
物	物 物品 物质 物体 物理 物件
帮	帮 帮助 帮忙 帮派 帮主 帮帮
喜	喜 喜欢 喜悦 喜爱 喜色 喜好
金	金 金色 金属 金钱 金光 金币
怕	怕 怕死 怕怕 怕事 怕麻烦 怕人
影	影 影响 影子 影视 影像 影响力
与	与 与此同时 与其 与众不同 与生俱来 与其说是
冷	冷 冷笑 冷静 冷汗 冷漠 冷冷的
爱	爱 爱情 爱好 爱国 爱人 爱丽丝
友	友 友谊 友好 友情 友善 友人
脑	脑 脑袋 脑海 脑海中 脑子 脑子里
往	往 往往 往常 往后 往前 往前走
办	办 办法 办公室 办公桌 办理 办事
步	步 步伐 步子 步入 步行 步枪
总	总 总是 总算 总之 总会 总裁
灵	灵 灵魂 灵气 灵力 灵活 灵光
嘴	嘴 嘴里 嘴角 嘴巴 嘴唇 嘴边
错	错 错误 错过 错觉 错愕 错乱
五	五 五个 五年 五分钟 五官 五十
教	教 教室 教官 教育 教训 教授
界	界 界面 界限 界碑 界内 界线
饭	饭 饭店 饭菜 饭桌 饭馆 饭后
刻	刻 刻苦 刻意 刻画 刻骨铭心 刻薄
至	至 至于 至少 至今 至极 至尊
乎	乎 乎呼
弟	弟 弟弟 弟子 弟兄 弟兄们 弟妹
语	语 语气 语文 语言 语文课 语音
每	每 每天 每个 每次 每年 每当
玩	玩 玩笑 玩意 玩游戏 玩玩 玩家
量	量 量子 量身 量身定做 量产 量变
指	指 指着 指向 指挥 指望 指导
青	青 青年 青春 青青 青云 青山
雨	雨 雨水 雨伞 雨滴 雨点 雨天
火	火 火车 火焰 火车站 火热 火爆
室	室 室友 室内 室外 室长 室内设计
双	双 双手 双眼 双腿 双方 双目
半	半 半个 半天 半年 半点 半小时
结	结 结果 结束 结婚 结局 结合
传	传 传来 传说 传出 传承 传统
传	传 传来 传说 传出 传承 传统
欢	欢 欢迎 欢快 欢喜 欢乐 欢呼
系	系 系统 系列 系统启动 系花 系主任
系	系 系统 系列 系统启动 系花 系主任
容	容 容易 容貌 容颜 容纳 容不得
句	句 句子 句号 句句 句点 句式
句	句 句子 句号 句句 句点 句式
忙	忙 忙碌 忙活 忙不迭 忙于 忙忙碌碌
失	失 失去 失望 失败 失落 失踪
收	收 收拾 收藏 收到 收回 收入
父	父 父亲 父母 父子 父母亲 父子俩
血	血 血液 血脉 血迹 血色 血红
衣	衣 衣服 衣领 衣着 衣物 衣柜
谢	谢 谢谢 谢谢你们 谢谢您 谢过 谢天谢地
拉	拉 拉开 拉拉 拉乌 拉扯 拉倒
度	度 度过 度假 度日 度日如年 度数
落	落 落下 落地 落到 落后 落寞
管	管 管理 管家 管理员 管不了 管教
日	日 日子 日本 日后 日常 日记
爸	爸 爸爸 爸妈 爸爸妈妈 爸媽 爸爸媽媽
整	整 整个 整理 整天 整整 整齐
准	准 准备 准确 准时 准则 准确无误
酒	酒 酒吧 酒店 酒杯 酒瓶 酒精
奇	奇 奇怪 奇迹 奇葩 奇异 奇妙
奇	奇 奇怪 奇迹 奇葩 奇异 奇妙
雪	雪 雪儿 雪白 雪花 雪茄 雪地
般	般 般的 般地 般配 般若 般般
凡	凡 凡人 凡是 凡间 凡事 凡尘
流	流 流氓 流出 流逝 流星 流露出
非	非 非常 非凡 非得 非洲 非但
星	星 星期 星球 星辰 星星 星空
件	件 件物品 件数 件产品 件套 件夹
赵	赵 赵云 赵家 赵老师 赵子龙 赵无极
宇	宇 宇宙 宇文 宇航 宇道 宇宙飞船
立	立 立刻 立马 立即 立正 立体
梦	梦 梦想 梦境 梦乡 梦见 梦幻
杀	杀 杀手 杀人 杀死 杀气 杀戮
旁	旁 旁边 旁人 旁观者 旁若无人 旁听
特	特 特别 特殊 特意 特种兵 特点
楚	楚 楚楚 楚歌 楚楚可怜 楚南 楚王
由	由 由于 由此 由衷 由来 由此可见
命	命 命运 命令 命名 命中 命中注定
苏	苏 苏醒 苏子 苏白 苏苏 苏菲
视	视 视线 视频 视野 视力 视觉
怪	怪 怪物 怪异 怪不得 怪怪的 怪兽
合	合 合适 合同 合作 合格 合理
合	合 合适 合同 合作 合格 合理
底	底 底下 底气 底线 底部 底子
市	市 市场 市里 市长 市区 市中心
包	包 包括 包裹 包子 包围 包厢
提	提 提醒 提升 提前 提出 提高
提	提 提醒 提升 提前 提出 提高
息	息 息怒 息息相关 息事宁人 息壤 息影
终	终 终于 终究 终点 终极 终结
备	备 备注 备用 备胎 备受 备战
条	条 条件 条件反射 条子 条纹 条约
识	识 识相 识趣 识字 识别 识破
识	识 识相 识趣 识字 识别 识破
保	保 保安 保护 保证 保镖 保持
告	告 告诉 告别 告知 告白 告辞
司	司 司机 司徒 司马 司空 司令
乐	乐 乐意 乐趣 乐天 乐观 乐乐
乐	乐 乐意 乐趣 乐天 乐观 乐乐
单	单 单位 单纯 单身 单独 单薄
单	单 单位 单纯 单身 单独 单薄
单	单 单位 单纯 单身 单独 单薄
近	近 近乎 近距离 近前 近视 近在咫尺
答	答 答应 答案 答道 答复 答话
题	题 题目 题材 题外话 题海 题记
夏	夏 夏天 夏日 夏侯 夏季 夏秋
脚	脚 脚步 脚下 脚步声 脚印 脚底
睡	睡 睡觉 睡着 睡不着 睡醒 睡意
伤	伤 伤害 伤口 伤心 伤感 伤势
冲	冲 冲着 冲动 冲向 冲击 冲出
够	够 够呛 够不够 够用 够意思 够快
夜	夜 夜晚 夜色 夜里 夜空 夜幕
请	请 请问 请假 请客 请求 请来
言	言 言语 言辞 言论 言归正传 言说
楼	楼 楼下 楼上 楼梯 楼道 楼房
性	性 性格 性感 性子 性命 性别
呵	呵 呵呵 呵斥 呵护 呵欠 呵气
呵	呵 呵呵 呵斥 呵护 呵欠 呵气
停	停 停下 停止 停留 停下来 停顿
根	根 根本 根据 根本就是 根本无法 根基
修	修 修炼 修改 修长 修行 修仙
城	城 城市 城里 城堡 城管 城里人
丝	丝 丝毫 丝丝 丝袜 丝线 丝绸
深	深 深深 深处 深刻 深夜 深邃
睛	睛 睛明穴 睛天 睛天霹雳 睛明 睛隆
母	母 母亲 母子 母女 母爱 母校
片	片 片刻 片子 片段 片片 片场
显	显 显得 显然 显示 显眼 显出
百	百 百年 百里 百万 百米 百姓
华	华 华夏 华丽 华国 华山 华人
敢	敢 敢不敢 敢动 敢于 敢情 敢肯定
战	战 战斗 战争 战场 战士 战斗力
级	级 级别 级任务 级数 级新生 级差
秦	秦 秦天 秦川 秦朝 秦牧 秦始皇
交	交 交给 交流 交代 交易 交谈
切	切 切磋 切记 切换 切割 切断
黄	黄 黄毛 黄金 黄色 黄昏 黄瓜
急	急 急忙 急促 急切 急匆匆 急速
穿	穿 穿着 穿越 穿过 穿梭 穿衣服
久	久 久久 久违 久而久之 久远 久等
绝	绝 绝对 绝望 绝不 绝世 绝不会
装	装 装作 装备 装修 装饰 装扮
业	业 业务 业绩 业务员 业余 业主
考	考 考虑 考试 考上 考验 考场
兴	兴 兴奋 兴趣 兴致 兴起 兴许
续	续 续命 续写 续集 续费 续约
顿	顿 顿时 顿饭 顿悟 顿觉 顿感
警	警 警察 警官 警惕 警告 警车
消	消 消失 消息 消耗 消散 消费
阵	阵 阵阵 阵法 阵势 阵营 阵容
赶	赶 赶紧 赶忙 赶快 赶到 赶上
妹	妹 妹妹 妹子 妹夫 妹儿 妹婿
喝	喝 喝酒 喝完 喝道 喝醉 喝茶
响	响 响起 响声 响亮 响彻 响指
它	它 它们 它山之石 它們
异	异 异能 异常 异能者 异样 异口同声
员	员 员工 员外 员工工资 员工福利 员工素质
速	速 速度 速度快 速速 速度慢 速战速决
留	留 留下 留在 留给 留下来 留恋
害	害 害怕 害羞 害死 害人 害臊
院	院 院子 院长 院里 院校 院落
苦	苦 苦笑 苦涩 苦恼 苦苦 苦难
使	使 使用 使得 使劲 使出 使命
朋	朋 朋友 朋友圈 朋友家 朋克 朋友妻
击	击 击中 击杀 击打 击败 击毙
石	石 石头 石子 石块 石碑 石门
石	石 石头 石子 石块 石碑 石门
化	化 化作 化为 化成 化学 化妆
凌	凌 凌晨 凌云 凌乱 凌厉 凌空
摇	摇 摇头 摇摇头 摇晃 摇摇晃晃 摇曳
武	武 武器 武功 武者 武术 武侠
亮	亮 亮光 亮起 亮点 亮丽 亮晶晶
暗	暗 暗暗 暗自 暗道 暗恋 暗骂
背	背 背后 背影 背着 背包 背上
毕	毕 毕竟 毕业 毕业生 毕业证 毕生
确	确 确实 确定 确认 确信 确切
千	千 千万 千年 千万别 千里 千金
断	断 断断续续 断裂 断定 断绝 断掉
照	照 照顾 照片 照射 照着 照耀
或	或 或者 或许 或是 或者说 或多或少
易	易 易水寒 易经 易拉罐 易筋经 易天行
各	各 各种 各位 各自 各个 各种各样
买	买 买点 买来 买卖 买菜 买下
代	代 代表 代价 代号 代替 代理
差	差 差不多 差点 差距 差别 差一点
差	差 差不多 差点 差距 差别 差一点
围	围 围着 围观 围绕 围墙 围住
即	即 即使 即将 即便 即可 即便如此
唐	唐 唐天 唐朝 唐僧 唐装 唐国
台	台 台上 台下 台阶 台词 台前
医	医 医院 医生 医术 医务室 医药费
队	队 队长 队伍 队员 队友 队里
拍	拍 拍了拍 拍拍 拍摄 拍照 拍打
呼	呼 呼吸 呼呼 呼喊 呼唤 呼啸
依	依 依旧 依然 依靠 依依 依稀
醒	醒 醒来 醒过来 醒醒 醒来时 醒悟
板	板 板凳 板砖 板着脸 板寸头 板块
精	精 精神 精致 精彩 精神力 精灵
习	习 习惯 习惯性 习以为常 习俗 习题
淡	淡 淡淡的 淡淡 淡然 淡淡地 淡蓝色
破	破 破旧 破坏 破碎 破烂 破口大骂
军	军 军训 军人 军队 军装 军事
浩	浩 浩然 浩瀚 浩劫 浩浩荡荡 浩大
送	送 送到 送给 送来 送走 送回
角	角 角落 角色 角落里 角度 角度看
待	待 待遇 待会儿 待见 待人 待在家里
吴	吴 吴子 吴起 吴用 吴越 吴哥
钟	钟 钟离 钟声 钟头 钟表 钟情
计	计 计划 计较 计算 计算机 计划生育
务	务 务必 务农 务工 务实 务工人员
期	期 期待 期间 期望 期盼 期末考试
期	期 期待 期间 期望 期盼 期末考试
报	报 报告 报道 报警 报仇 报名
晓	晓 晓得 晓之以理 晓露 晓风残月 晓芙
默	默 默默 默默地 默念 默契 默认
写	写 写作 写下 写出 写手 写字
掉	掉 掉落 掉下来 掉落在 掉下去 掉头
阿	阿 阿姨 阿飞 阿弥陀佛 阿明 阿婆
鬼	鬼 鬼魂 鬼脸 鬼子 鬼神 鬼魅
况	况 况且 况味 况浩文
求	求 求求 求饶 求救 求助 求生
萧	萧 萧然 萧瑟 萧萧 萧条 萧山
决	决 决定 决心 决斗 决绝 决赛
功	功 功夫 功法 功能 功德 功力
八	八 八卦 八点 八个 八年 八岁
块	块 块钱 块头 块儿 块砖 块状
伙	伙 伙伴 伙计 伙食 伙食费 伙房
继	继 继续 继承 继而 继承人 继续下去
试	试 试试 试卷 试图 试探 试验
混	混 混混 混蛋 混沌 混乱 混合
利	利 利用 利益 利索 利润 利剑
低	低 低头 低着头 低声 低下头 低调
沉	沉 沉默 沉重 沉思 沉浸 沉睡
露	露 露出 露露 露天 露面 露水
简	简 简单 简直 简历 简陋 简介
球	球 球场 球员 球队 球场上 球体
峰	峰 峰顶 峰回路转 峰会 峰峦 峰点
必	必 必须 必要 必然 必定 必备
叔	叔 叔叔 叔伯 叔公 叔父 叔侄
哦	哦 哦哦哦
诉	诉 诉说 诉说着 诉苦 诉讼 诉求
复	复 复杂 复习 复活 复制 复读
江	江 江湖 江南 江海 江城 江山
课	课 课本 课程 课堂 课桌 课间
注	注 注意 注视 注定 注意力 注册
顾	顾 顾客 顾不得 顾不上 顾忌 顾及
店	店 店里 店铺 店长 店面 店主
抱	抱 抱歉 抱怨 抱住 抱头 抱拳
朝	朝 朝着 朝阳 朝气 朝代 朝廷
朝	朝 朝着 朝阳 朝气 朝代 朝廷
呀	呀 呀呀 呀呀学语 呀儿哟
刀	刀 刀疤 刀子 刀刃 刀锋 刀尖
段	段 段时间 段子 段位 段落 段距离
若	若 若有所思 若隐若现 若无其事 若有若无 若非
床	床 床上 床边 床头 床铺 床单
肯	肯 肯定 肯德基 肯干 肯纳 肯给
客	客 客气 客厅 客人 客户 客栈
尽	尽 尽管 尽量 尽头 尽快 尽力
疑	疑 疑惑 疑问 疑虑 疑似 疑点
群	群 群众 群体 群山 群殴 群主
桌	桌 桌子 桌上 桌前 桌面 桌面上
号	号 号码 号称 号召 号令 号子
众	众 众人 众多 众生 众所周知 众位
木	木 木头 木棍 木板 木子 木门
缓	缓 缓缓 缓缓的 缓慢 缓解 缓和
制	制 制作 制造 制服 制止 制度
兄	兄 兄弟 兄妹 兄弟姐妹 兄弟俩 兄妹俩
需	需 需要 需求 需不需要 需要的话 需求量
居	居 居然 居住 居民 居高临下 居民楼
初	初 初中 初三 初级 初一 初恋
程	程 程度 程序 程程 程序员 程志
古	古 古代 古怪 古老 古董 古玩
格	格 格外 格斗 格格不入 格子 格局
极	极 极为 极其 极品 极了 极大
您	您 您好 您老 您们 您慢 您瞧
靠	靠 靠近 靠着 靠窗 靠山 靠墙
玉	玉 玉佩 玉石 玉帝 玉米 玉手
晨	晨 晨曦 晨练 晨风 晨光 晨读
米	米 米饭 米左右 米粒 米处 米线
热	热 热闹 热情 热血 热水 热烈
痛	痛 痛苦 痛快 痛楚 痛哭 痛恨
未	未 未来 未知 未曾 未必 未婚妻
足	足 足够 足以 足足 足球 足足有
招	招 招呼 招手 招聘 招惹 招式
莫	莫 莫名 莫名其妙 莫非 莫大 莫言
除	除 除了 除非 除此之外 除去 除外
及	及 及时 及其 及格 及格线 及时雨
持	持 持续 持枪 持有 持刀 持久
游	游 游戏 游客 游泳 游走 游荡
超	超 超级 超过 超市 超能力 超越
充	充 充满 充数 充斥 充分 充足
希	希 希望 希冀 希腊 希尔 希克
份	份 份子 份儿 份量 份额 份文件
则	则 则安之 则甚 则例 则声明 则徐
喊	喊 喊道 喊声 喊叫 喊出来 喊话
冰	冰 冰冷 冰箱 冰凉 冰冰 冰山
势	势 势力 势头 势必 势利 势利眼
推	推 推开 推荐 推门 推出 推进
孙	孙 孙子 孙悟空 孙女 孙儿 孙家
形	形 形成 形象 形容 形状 形式
胖	胖 胖子 胖胖的 胖乎乎 胖女人 胖墩
狠	狠 狠狠 狠心 狠辣 狠毒 狠劲
拳	拳 拳头 拳法 拳打脚踢 拳脚 拳击
跳	跳 跳动 跳跃 跳舞 跳楼 跳出
抓	抓 抓住 抓起 抓紧 抓狂 抓紧时间
南	南 南宫 南方 南山 南京 南城
左	左 左右 左手 左边 左侧 左脚
细	细 细节 细细 细胞 细腻 细心
病	病 病房 病人 病床 病毒 病情
乱	乱 乱七八糟 乱说 乱跑 乱糟糟 乱动
股	股 股票 股份 股市 股东 股子
陆	陆 陆续 陆陆续续 陆风 陆羽 陆地
魔	魔 魔法 魔鬼 魔力 魔王 魔术
轩	轩 轩辕 轩辕剑 轩辕黄帝 轩然大波 轩昂
首	首 首先 首歌 首长 首领 首都
右	右 右手 右边 右脚 右侧 右腿
类	类 类似 类型 类人 类别 类人猿
选	选 选择 选项 选手 选中 选出
宝	宝 宝贝 宝宝 宝马 宝石 宝物
另	另 另外 另一边 另一只 另一头 另类
排	排 排名 排队 排除 排斥 排行
忍	忍 忍不住 忍住 忍受 忍者 忍耐
韩	韩 韩国 韩语 韩剧 韩文 韩信
味	味 味道 味儿 味觉 味蕾 味精
午	午 午饭 午餐 午后 午夜 午休
品	品 品牌 品尝 品质 品味 品种
徐	徐 徐徐 徐福 徐家 徐闻 徐洋
士	士 士兵 士气 士官 士卒 士可杀不
七	七 七点 七个 七年 七八个 七天
丽	丽 丽丽 丽莎 丽江 丽人 丽萨
皮	皮 皮肤 皮鞋 皮包 皮毛 皮箱
罗	罗 罗兰 罗盘 罗阳 罗汉 罗斯
线	线 线索 线条 线路 线装书 线头
练	练 练习 练武 练功 练气 练成
渐	渐 渐渐 渐暗 渐近 渐黑 渐进
区	区 区别 区域 区区 区分 区内
区	区 区别 区域 区区 区分 区内
烟	烟 烟雾 烟头 烟花 烟消云散 烟盒
吸	吸 吸引 吸收 吸血鬼 吸引力 吸烟
瞬	瞬 瞬间 瞬移 瞬时 瞬息 瞬间反应
六	六 六个 六点 六年 六月 六岁
护	护 护士 护栏 护住 护卫 护送
怒	怒 怒火 怒吼 怒气 怒视 怒气冲冲
术	术 术士 术语 术者 术后 术数
术	术 术士 术语 术者 术后 术数
辰	辰 辰星 辰龙 辰溪 辰阳 辰时
毛	毛 毛病 毛巾 毛毛 毛骨悚然 毛发
巴	巴 巴掌 巴不得 巴结 巴黎 巴士
凑	凑 凑足 凑合 凑近 凑热闹 凑巧
熟	熟 熟悉 熟练 熟人 熟睡 熟络
建	建 建筑 建议 建立 建国 建设
达	达 达到 达成 达标 达克 达摩
剑	剑 剑眉 剑法 剑气 剑柄 剑南
运	运 运气 运动 运转 运用 运行
寒	寒 寒冷 寒风 寒意 寒光 寒暄
领	领 领导 领头 领域 领取 领悟
枪	枪 枪声 枪口 枪响 枪械 枪法
摸	摸 摸了摸 摸摸 摸索 摸不着头脑 摸爬滚打
岁	岁 岁月 岁数 岁月如梭 岁月不饶人 岁月流逝
象	象 象征 象征性 象是 象棋 象牙
羽	羽 羽毛 羽绒服 羽翼 羽毛球 羽化
换	换 换上 换成 换来 换衣服 换取
虎	虎 虎子 虎视眈眈 虎头 虎背熊腰 虎口
副	副 副驾驶 副校长 副本 副局长 副作用
察	察 察觉到 察觉 察言观色 察看 察觉出
激	激 激动 激烈 激情 激活 激灵
论	论 论坛 论文 论语 论述 论证
闪	闪 闪过 闪电 闪烁 闪烁着 闪现
元	元 元素 元气 元旦 元帅 元老
网	网 网吧 网络 网上 网站 网络小说
松	松 松开 松手 松树 松懈 松鼠
呆	呆 呆呆 呆滞 呆住 呆呆地 呆子
呆	呆 呆呆 呆滞 呆住 呆呆地 呆子
资	资 资料 资格 资源 资金 资本
念	念 念头 念叨 念书 念道 念完
调	调 调查 调侃 调整 调皮 调戏
调	调 调查 调侃 调整 调皮 调戏
袋	袋 袋子 袋中 袋鼠 袋装 袋口
愿	愿 愿意 愿望 愿不愿意 愿赌服输 愿不愿
枫	枫 枫叶 枫林 枫树 枫桥 枫城
节	节 节奏 节目 节操 节日 节省
讲	讲 讲台 讲话 讲究 讲述 讲课
怀	怀 怀疑 怀里 怀中 怀着 怀念
故	故 故事 故意 故作 故乡 故而
咱	咱 咱们 咱俩 咱家 咱班 咱村
娘	娘 娘娘 娘家 娘亲 娘俩 娘娘腔
散	散 散发 散发出 散落 散步 散开
雷	雷 雷电 雷劈 雷霆 雷声 雷鸣
啦	啦 啦啦队 啦啦队员 啦啦队长
顺	顺 顺着 顺便 顺利 顺手 顺势
救	救 救命 救人 救护车 救救 救援
哭	哭 哭泣 哭声 哭笑不得 哭腔 哭喊
官	官 官方 官员 官场 官兵 官家
改	改 改变 改造 改天 改善 改成
器	器 器官 器材 器具 器械 器重
团	团 团队 团长 团结 团伙 团体
抬	抬 抬头 抬起 抬手 抬起头来 抬脚
观	观 观察 观看 观众 观点 观望
聊	聊 聊天 聊着 聊聊 聊得 聊聊天
菜	菜 菜刀 菜单 菜鸟 菜市场 菜肴
胡	胡 胡乱 胡思乱想 胡子 胡同 胡说
费	费 费用 费力 费劲 费心 费解
奶	奶 奶奶 奶茶 奶粉 奶奶家 奶油
追	追 追求 追问 追杀 追逐 追求者
麻	麻 麻烦 麻木 麻痹 麻利 麻子
志	志 志远 志愿 志强 志成 志向
香	香 香烟 香味 香港 香气 香江
歌	歌 歌曲 歌声 歌手 歌词 歌唱
压	压 压力 压抑 压根 压制 压低
恶	恶 恶心 恶魔 恶狠狠 恶意 恶作剧
恶	恶 恶心 恶魔 恶狠狠 恶意 恶作剧
忘	忘 忘记 忘不了 忘掉 忘却 忘不掉
树	树 树林 树上 树叶 树木 树枝
景	景 景象 景色 景物 景区 景点
掌	掌 掌握 掌控 掌声 掌门 掌心
严	严 严肃 严重 严厉 严格 严谨
局	局 局长 局面 局里 局势 局子
座	座 座位 座椅 座机 座右铭 座无虚席
耳	耳 耳朵 耳边 耳机 耳光 耳畔
肉	肉 肉体 肉眼 肉身 肉麻 肉丝
村	村 村里 村子 村长 村民 村庄
恐	恐 恐怕 恐惧 恐怖 恐慌 恐龙
挺	挺 挺拔 挺不错 挺直 挺快 挺起
示	示 示意 示弱 示范 示威 示好
吓	吓 吓了一跳 吓人 吓死 吓坏 吓唬
吓	吓 吓了一跳 吓人 吓死 吓坏 吓唬
戏	戏 戏谑 戏弄 戏耍 戏剧 戏称
戏	戏 戏谑 戏弄 戏耍 戏剧 戏称
存	存 存在 存款 存活 存放 存储
俩	俩 俩个 俩眼 俩家 俩一 俩把
导	导 导致 导演 导师 导游 导弹
基	基 基本 基本上 基础 基地 基因
式	式 式样 式微 式子 式作业 式打印机
九	九 九点 九天 九月 九个 九年
杰	杰 杰克 杰作 杰出 杰瑞 杰西卡
烦	烦 烦恼 烦躁 烦人 烦闷 烦死
英	英 英雄 英语 英俊 英语老师 英雄救美
狗	狗 狗血 狗屁 狗子 狗蛋 狗腿子
约	约 约定 约会 约莫 约束 约翰
翻	翻 翻开 翻身 翻滚 翻白眼 翻看
佛	佛 佛祖 佛教 佛像 佛珠 佛门
态	态 态度 态势 态度强硬 态度端正 态度恶劣
柳	柳 柳树 柳眉 柳青 柳叶眉 柳家
甚	甚 甚至 甚至于 甚远 甚么 甚为
既	既 既然 既然如此 既来之 既有 既定
置	置 置信 置身于 置身 置于 置办
舍	舍 舍不得 舍友 舍得 舍弃 舍长
迷	迷 迷茫 迷迷糊糊 迷人 迷糊 迷惑
族	族 族长 族人 族群 族谱 族规
查	查 查看 查询 查查 查找 查出
查	查 查看 查询 查查 查找 查出
遇	遇 遇到 遇见 遇上 遇事 遇难
统	统 统一 统统 统治 统计 统领
组	组 组织 组成 组长 组合 组建
弄	弄 弄死 弄清楚 弄成 弄出来 弄错
弄	弄 弄死 弄清楚 弄成 弄出来 弄错
曾	曾 曾经 曾几何时 曾多次 曾一度 曾祖父
曾	曾 曾经 曾几何时 曾多次 曾一度 曾祖父
嘿	嘿 嘿嘿 嘿嘿嘿 嘿嘿不语
嘿	嘿 嘿嘿 嘿嘿嘿 嘿嘿不语
摆	摆 摆手 摆脱 摆在 摆摆手 摆弄
腿	腿 腿部 腿脚 腿软 腿法 腿肚子
眉	眉 眉头 眉毛 眉心 眉头一皱 眉宇
仅	仅 仅仅 仅仅只是 仅剩 仅此而已 仅存
较	较 较为 较大 较量 较劲 较真
蓝	蓝 蓝色 蓝天 蓝光 蓝衣 蓝天白云
集	集 集团 集中 集合 集体 集市
布	布 布满 布置 布局 布鞋 布袋
按	按 按照 按钮 按着 按住 按摩
药	药 药材 药剂 药物 药水 药丸
证	证 证明 证据 证件 证实 证书
取	取 取出 取得 取而代之 取消 取名
夫	夫 夫人 夫妻 夫妇 夫妻俩 夫君
伸	伸 伸手 伸出 伸出手 伸向 伸进
牛	牛 牛仔裤 牛奶 牛肉 牛仔 牛排
担	担 担心 担忧 担任 担当 担架
幸	幸 幸福 幸好 幸运 幸亏 幸灾乐祸
斗	斗 斗争 斗气 斗志 斗篷 斗嘴
料	料 料到 料理 料想 料子 料定
宿	宿 宿舍 宿主 宿舍楼 宿命 宿醉
宿	宿 宿舍 宿主 宿舍楼 宿命 宿醉
支	支 支持 支撑 支支吾吾 支援 支付
雅	雅 雅典娜 雅静 雅洁 雅致 雅丽
止	止 止住 止不住 止血 止步 止痛
坏	坏 坏人 坏事 坏蛋 坏话 坏掉
蛋	蛋 蛋糕 蛋蛋 蛋炒饭 蛋壳 蛋糕店
偷	偷 偷偷 偷看 偷袭 偷笑 偷偷地
温	温 温柔 温暖 温度 温馨 温和
模	模 模样 模糊 模式 模仿 模拟
毫	毫 毫无 毫不犹豫 毫不 毫不在意 毫无疑问
假	假 假装 假期 假如 假设 假山
抽	抽 抽烟 抽奖 抽出 抽搐 抽屉
懂	懂 懂得 懂事 懂吗 懂不懂 懂行
洗	洗 洗漱 洗澡 洗手间 洗完 洗脸
炼	炼 炼制 炼化 炼丹 炼气 炼狱
质	质 质量 质疑 质问 质感 质地
隐	隐 隐藏 隐隐 隐约 隐隐约约 隐瞒
商	商 商量 商场 商业 商店 商人
引	引 引起 引来 引导 引发 引得
屋	屋 屋里 屋子 屋子里 屋内 屋顶
架	架 架势 架子 架不住 架起 架上
傻	傻 傻子 傻笑 傻眼 傻傻的 傻瓜
负	负 负责 负担 负责人 负面 负重
短	短 短信 短发 短暂 短短 短短的
食	食 食堂 食物 食指 食品 食欲
食	食 食堂 食物 食指 食品 食欲
层	层 层次 层层 层面 层出不穷 层楼
欣	欣 欣赏 欣慰 欣喜 欣然 欣欣
泪	泪 泪水 泪流满面 泪花 泪痕 泪珠
技	技 技能 技术 技巧 技校 技艺
齐	齐 齐齐 齐声 齐全 齐刷刷 齐鸣
价	价 价格 价值 价钱 价值观 价位
卖	卖 卖掉 卖力 卖出去 卖出 卖菜
闹	闹 闹钟 闹事 闹腾 闹着玩 闹剧
威	威 威胁 威力 威严 威武 威压
奈	奈 奈何 奈何桥 奈尔 奈特 奈良
沈	沈 沈默 沈家 沈阳 沈静 沈老师
沈	沈 沈默 沈家 沈阳 沈静 沈老师
宁	宁 宁静 宁愿 宁可 宁城 宁海
铁	铁 铁门 铁棍 铁蛋 铁青 铁柱
退	退 退出 退学 退休 退后 退伍
忽	忽 忽然 忽略 忽悠 忽然间 忽视
谈	谈 谈话 谈恋爱 谈谈 谈论 谈不上
堂	堂 堂堂 堂哥 堂屋 堂主 堂弟
余	余 余光 余地 余生 余额 余晖
画	画 画面 画画 画像 画卷 画家
猛	猛 猛地 猛然 猛烈 猛兽 猛然间
福	福 福利 福伯 福气 福利院 福分
叹	叹 叹息 叹气 叹口气 叹一口气 叹息声
洛	洛 洛阳 洛城 洛杉矶 洛伊 洛川
斯	斯 斯文 斯斯文文 斯特 斯诺 斯巴达
魂	魂 魂魄 魂飞魄散 魂不守舍 魂牵梦绕 魂灵
愣	愣 愣住 愣愣 愣神 愣头青 愣头愣脑
扬	扬 扬起 扬长而去 扬帆 扬子 扬言
展	展 展开 展现 展示 展现出 展露
境	境 境界 境地 境内 境况 境遇
墨	墨 墨镜 墨迹 墨家 墨水 墨绿色
民	民 民警 民族 民工 民间 民众
属	属 属于 属性 属下 属实 属狗
属	属 属于 属性 属下 属实 属狗
狼	狼 狼狈 狼吞虎咽 狼群 狼狗 狼嚎
狂	狂 狂奔 狂风 狂笑 狂喜 狂暴
巨	巨 巨大 巨响 巨人 巨石 巨型
顶	顶 顶级 顶尖 顶多 顶端 顶上
礼	礼 礼貌 礼物 礼拜 礼包 礼仪
哼	哼 哼哼 哼唱 哼起 哼哼唧唧 哼声
卡	卡 卡片 卡车 卡里 卡住 卡通
卡	卡 卡片 卡车 卡里 卡住 卡通
哎	哎 哎呀 哎哟 哎呀呀 哎喲
令	令 令人 令牌 令人发指 令人窒息 令狐冲
昨	昨 昨天 昨晚 昨天晚上 昨日 昨夜
承	承 承认 承受 承诺 承担 承包
具	具 具体 具有 具备 具体情况 具体位置
草	草 草坪 草泥马 草丛 草地上 草原
历	历 历史 历练 历经 历历在目 历程
恩	恩 恩爱 恩人 恩怨 恩赐 恩情
挥	挥 挥手 挥舞 挥挥手 挥动 挥霍
仿	仿 仿佛 仿若 仿古 仿真 仿制
仙	仙 仙人 仙界 仙子 仙女 仙侠
骂	骂 骂人 骂骂咧咧 骂声 骂娘 骂谁
普	普 普通 普通人 普普通通 普通话 普遍
帅	帅 帅气 帅哥 帅小伙 帅哥美女 帅呆了
兵	兵 兵器 兵团 兵力 兵来将挡 兵种
义	义 义气 义务 义无反顾 义愤填膺 义务教育
阴	阴 阴沉 阴影 阴阳 阴暗 阴冷
闻	闻 闻言 闻到 闻声 闻名 闻人
休	休 休息 休闲 休息室 休闲装 休息时间
释	释 释放 释然 释怀 释放出 释放出来
疼	疼 疼痛 疼爱 疼痛感 疼疼 疼惜
状	状 状态 状况 状元 状物 状元郎
紫	紫 紫色 紫光 紫衣 紫气 紫云
窗	窗 窗外 窗户 窗口 窗帘 窗前
挂	挂 挂断 挂掉 挂满 挂不住 挂钟
产	产 产生 产品 产业 产物 产房
联	联 联系 联盟 联想 联系方式 联合
克	克 克制 克拉 克里斯 克服 克星
忆	忆 忆起 忆往昔 忆苦思甜 忆江南 忆及
伟	伟 伟大 伟哥 伟人 伟岸 伟业
演	演 演员 演讲 演技 演出 演戏
升	升 升级 升起 升职 升高 升腾
弹	弹 弹性 弹幕 弹奏 弹夹 弹开
弹	弹 弹性 弹幕 弹奏 弹夹 弹开
街	街 街道 街上 街头 街边 街角
杯	杯 杯子 杯酒 杯中 杯水 杯水车薪
秘	秘 秘密 秘书 秘籍 秘诀 秘方
秘	秘 秘密 秘书 秘籍 秘诀 秘方
造	造 造成 造型 造化 造就 造诣
密	密 密码 密密麻麻 密集 密室 密布
独	独 独自 独立 独特 独自一人 独有
德	德 德行 德国 德性 德华 德鲁伊
旧	旧 旧金山 旧书 旧时 旧衣服 旧社会
举	举 举起 举动 举行 举办 举手
柔	柔 柔软 柔和 柔弱 柔顺 柔情
刺	刺 刺激 刺眼 刺耳 刺痛 刺杀
弱	弱 弱小 弱点 弱者 弱智 弱不禁风
厉	厉 厉害 厉声 厉鬼 厉色 厉之色
北	北 北京 北方 北辰 北大 北边
透	透 透过 透露 透明 透出 透视
助	助 助理 助手 助力 助人为乐 助跑
肩	肩 肩膀 肩上 肩头 肩并肩 肩部
科	科 科技 科学 科学家 科目 科长
震	震 震惊 震撼 震动 震天 震耳欲聋
养	养 养成 养活 养父 养生 养眼
野	野 野兽 野猪 野狼 野心 野外
鱼	鱼 鱼儿 鱼塘 鱼肉 鱼缸 鱼竿
躺	躺 躺倒 躺椅 躺下来 躺下去 躺进
沙	沙 沙发 沙哑 沙漠 沙滩 沙子
卫	卫 卫生间 卫生 卫星 卫国 卫东
搞	搞 搞定 搞笑 搞错 搞清楚 搞不懂
议	议 议论 议论纷纷 议论声 议会 议员
划	划 划过 划破 划分 划出 划开
社	社 社会 社团 社长 社区 社会主义
汉	汉 汉子 汉语 汉堡 汉字 汉族
致	致 致命 致远 致使 致死 致富
尔	尔 尔虞我诈 尔后 尔特 尔菲 尔德
坚	坚 坚持 坚定 坚强 坚决 坚毅
劲	劲 劲儿 劲风 劲头 劲力 劲松
握	握 握住 握紧 握手 握拳 握紧拳头
慕	慕 慕容 慕容雪 慕容家 慕容云 慕名而来
尘	尘 尘土 尘埃 尘封 尘世 尘土飞扬
训	训 训练 训斥 训练场 训练营 训话
值	值 值得 值钱 值班 值日 值班室
称	称 称呼 称为 称号 称之为 称赞
春	春 春天 春节 春风 春秋 春花
控	控 控制 控制不了 控制权 控制力 控诉
读	读 读书 读者 读完 读取 读心术
秋	秋 秋天 秋风 秋雨 秋水 秋季
脱	脱 脱离 脱掉 脱口而出 脱俗 脱落
餐	餐 餐厅 餐馆 餐桌 餐桌上 餐具
盘	盘 盘子 盘古 盘旋 盘腿 盘算着
专	专 专业 专门 专家 专心 专注
套	套 套路 套装 套房 套近乎 套餐
碎	碎 碎片 碎裂 碎石 碎花 碎成
究	究 究竟 究其原因 究其 究其根源 究根
盯	盯 盯上 盯住 盯紧 盯梢 盯视
厅	厅 厅堂 厅长 厅里 厅级 厅房
笔	笔 笔记本 笔直 笔记 笔记本电脑 笔录
姑	姑 姑娘 姑姑 姑奶奶 姑父 姑妈
土	土 土地 土豪 土豆 土包子 土匪
藏	藏 藏獒 藏身 藏不住 藏有 藏书
藏	藏 藏獒 藏身 藏不住 藏有 藏书
额	额 额头 额外 额前 额度 额角
逸	逸 逸仙 逸夫 逸才 逸散 逸夫楼
胸	胸 胸口 胸前 胸膛 胸部 胸脯
章	章 章节 章鱼 章子 章法 章程
介	介 介绍 介意 介入 介于 介绍信
爆	爆 爆发 爆炸 爆出 爆炸声 爆裂
付	付 付出 付钱 付出代价 付强 付款
幕	幕 幕后 幕布 幕墙 幕僚 幕府
惑	惑 惑乱 惑众 惑世诬民 惑乱人心
欧	欧 欧阳 欧洲 欧阳明 欧式 欧美
郑	郑 郑重 郑重其事 郑家 郑州 郑和
纸	纸 纸条 纸巾 纸张 纸片 纸币
镜	镜 镜子 镜头 镜片 镜面 镜框
泽	泽 泽西 泽被 泽塔 泽国 泽泻
舒	舒 舒服 舒适 舒展 舒畅 舒坦
案	案 案子 案件 案例 案发现场 案板
禁	禁 禁止 禁不住 禁锢 禁忌 禁地
陪	陪 陪伴 陪陪 陪同 陪你去 陪伴着
虚	虚 虚空 虚弱 虚拟 虚无 虚幻
险	险 险些 险恶 险境 险峻 险险
宋	宋 宋朝 宋明 宋家 宋代 宋江
呜	呜 呜呜 呜咽 呜呼 呜呜声 呜呼哀哉
豪	豪 豪华 豪爽 豪门 豪气 豪宅
园	园 园子 园长 园林 园区 园里
贵	贵 贵族 贵重 贵族学校 贵人 贵姓
据	据 据说 据我所知 据点 据传 据理力争
图	图 图书馆 图案 图片 图标 图纸
良	良 良久 良好 良辰 良心 良民
辈	辈 辈分 辈子 辈份 辈出 辈数
剩	剩 剩下 剩余 剩饭 剩菜 剩余时间
尸	尸 尸体 尸骨 尸王 尸身 尸首
墙	墙 墙上 墙壁 墙角 墙边 墙面
秀	秀 秀发 秀气 秀丽 秀眉 秀英
皱	皱 皱眉 皱着眉头 皱眉头 皱起 皱纹
择	择 择偶 择日 择菜 择校费 择业
择	择 择偶 择日 择菜 择校费 择业
辆	辆 辆车 辆次 辆数
骨	骨 骨头 骨骼 骨子里 骨折 骨气
躲	躲 躲过 躲避 躲开 躲闪 躲起来
兰	兰 兰博基尼 兰花 兰兰 兰州 兰花指
逃	逃 逃跑 逃离 逃避 逃课 逃走
碰	碰 碰到 碰上 碰撞 碰见 碰巧
灯	灯 灯光 灯火 灯火通明 灯红酒绿 灯泡
补	补 补充 补偿 补习 补课 补补
撞	撞 撞击 撞死 撞倒 撞开 撞见
富	富 富贵 富裕 富有 富豪 富人
银	银 银行 银行卡 银色 银白色 银针
田	田 田野 田地 田里 田间 田园
舞	舞 舞台 舞蹈 舞池 舞动 舞会
标	标 标准 标志 标题 标签 标记
波	波 波动 波澜 波浪 波纹 波及
材	材 材料 材质 材料费 材料科 材料价格
昊	昊 昊天 昊天罔极
印	印 印象 印记 印度 印证 印有
攻	攻 攻击 攻势 攻击力 攻略 攻打
烈	烈 烈日 烈火 烈焰 烈酒 烈士
投	投 投入 投资 投胎 投票 投向
牙	牙 牙齿 牙刷 牙膏 牙签 牙痒痒
智	智 智商 智慧 智能 智力 智能手机
否	否 否则 否定 否认 否决 否极泰来
否	否 否则 否定 否认 否决 否极泰来
闭	闭 闭上眼睛 闭嘴 闭上眼 闭眼 闭目养神
洋	洋 洋溢着 洋洋 洋溢 洋洋得意 洋娃娃
纪	纪 纪念 纪律 纪元 纪录 纪委
寻	寻 寻找 寻常 寻思 寻求 寻觅
啥	啥 啥事 啥时候 啥子 啥意思 啥样子
剧	剧 剧烈 剧情 剧痛 剧本 剧组
环	环 环境 环绕 环视 环顾 环顾四周
喂	喂 喂喂 喂养 喂猪 喂狗 喂奶
俊	俊 俊俏 俊美 俊朗 俊杰 俊秀
婆	婆 婆婆 婆娘 婆娑 婆婆妈妈 婆子
漂	漂 漂亮 漂浮 漂泊 漂亮女孩 漂移
擦	擦 擦拭 擦擦 擦肩而过 擦干 擦掉
派	派 派出所 派出 派遣 派对 派头
趣	趣 趣事 趣味 趣闻 趣味性 趣闻轶事
束	束 束缚 束手无策 束手就擒 束腰 束成
佳	佳 佳佳 佳人 佳丽 佳美 佳话
妖	妖 妖怪 妖孽 妖娆 妖艳 妖精
累	累 累死 累赘 累坏 累计 累积
吐	吐 吐出 吐血 吐出来 吐舌头 吐沫
纷	纷 纷纷 纷飞 纷争 纷乱 纷纷议论
永	永 永远 永恒 永远都是 永生 永不
估	估 估计 估摸 估算 估量 估价
牌	牌 牌子 牌匾 牌照 牌位 牌坊
圈	圈 圈子 圈子里 圈圈 圈套 圈里
圈	圈 圈子 圈子里 圈圈 圈套 圈里
颜	颜 颜色 颜面 颜料 颜如玉 颜面扫地
暴	暴 暴露 暴力 暴躁 暴雨 暴怒
惜	惜 惜字如金 惜惜 惜命 惜别 惜败
暴	暴 暴露 暴力 暴躁 暴雨 暴怒
君	君 君子 君王 君临 君主 君临天下
遍	遍 遍布 遍地 遍体鳞伤 遍野 遍及
票	票 票子 票房 票数 票价 票据
型	型 型号 型态 型式 型飞机 型基金
争	争 争取 争吵 争夺 争执 争斗
疯	疯 疯狂 疯子 疯狗 疯疯癫癫 疯癫
临	临 临时 临近 临走 临走时 临走前
端	端 端木 端详 端坐 端庄 端正
某	某 某个 某些 某种 某人 某某
婷	婷 婷婷 婷婷玉立 婷美
废	废 废话 废物 废弃 废墟 废品
参	参 参加 参与 参观 参考 参赛
参	参 参加 参与 参观 参考 参赛
河	河 河边 河里 河水 河流 河道
弃	弃 弃子 弃婴 弃权 弃儿 弃学
借	借 借口 借着 借钱 借助 借给
仔	仔 仔细 仔细观察 仔仔细细 仔细想 仔细听
菲	菲 菲尔 菲律宾 菲特 菲斯 菲娜
唯	唯 唯一 唯有 唯独 唯美 唯唯诺诺
源	源 源头 源源不断 源于 源自 源泉
封	封 封印 封面 封信 封闭 封锁
须	须 须臾 须菩提 须知 须发皆白 须弥
拥	拥 拥有 拥抱 拥挤 拥有者 拥堵
验	验 验证 验尸 验收 验货 验血
挑	挑 挑战 挑衅 挑选 挑逗 挑起
索	索 索性 索索 索要 索然无味 索命
毅	毅 毅力 毅然 毅然决然 毅然决定 毅然投入
恨	恨 恨不得 恨铁不成钢 恨意 恨不能 恨死
硬	硬 硬是 硬生生 硬着头皮 硬币 硬朗
滚	滚 滚蛋 滚滚 滚开 滚烫 滚出去
奋	奋 奋斗 奋力 奋战 奋笔疾书 奋不顾身
胜	胜 胜利 胜负 胜过 胜任 胜算
责	责 责任 责怪 责备 责编 责骂
丢	丢 丢人 丢下 丢脸 丢掉 丢失
肖	肖 肖扬 肖恩 肖像 肖邦 肖像权
杂	杂 杂志 杂乱 杂草 杂物 杂质
晴	晴 晴天 晴朗 晴天霹雳 晴儿 晴空万里
逼	逼 逼近 逼迫 逼人 逼真 逼问
码	码 码字 码头 码子 码放 码表
货	货 货车 货物 货色 货币 货架
守	守 守护 守卫 守护者 守候 守住
适	适 适合 适应 适当 适时 适宜
配	配 配合 配置 配不上 配角 配方
适	适 适合 适应 适当 适时 适宜
唱	唱 唱歌 唱片 唱功 唱起 唱着歌
广	广 广场 广告 广播 广大 广州
广	广 广场 广告 广播 广大 广州
咬	咬 咬牙 咬牙切齿 咬着牙 咬咬牙 咬了一口
杜	杜 杜宇 杜康 杜家 杜绝 杜鹃
丹	丹 丹田 丹药 丹丹 丹凤眼 丹阳
婚	婚 婚礼 婚姻 婚事 婚纱 婚约
帝	帝 帝国 帝王 帝都 帝皇 帝君
曲	曲 曲线 曲子 曲折 曲调 曲谱
腰	腰 腰间 腰部 腰带 腰肢 腰板
规	规 规矩 规定 规则 规律 规划
滴	滴 滴滴 滴答 滴血 滴落 滴水
犹	犹 犹豫 犹如 犹豫不决 犹犹豫豫 犹疑
败	败 败家 败类 败家子 败给 败坏
悠	悠 悠闲 悠悠 悠然 悠悠的 悠扬
糊	糊 糊涂 糊弄 糊里糊涂 糊口 糊糊
迎	迎 迎接 迎来 迎面 迎面而来 迎宾
油	油 油门 油条 油然而生 油漆 油腻
茶	茶 茶几 茶杯 茶水 茶叶 茶馆
户	户 户口 户外 户口本 户籍 户主
屁	屁 屁股 屁事 屁用 屁话 屁屁
聚	聚 聚集 聚会 聚在一起 聚餐 聚精会神
设	设 设计 设定 设备 设置 设施
浪	浪 浪费 浪漫 浪费时间 浪花 浪子
操	操 操场 操作 操场上 操心 操控
赛	赛 赛车 赛场 赛事 赛跑 赛道
睁	睁 睁开 睁开眼睛 睁开眼 睁眼 睁不开
谓	谓 谓之 谓语 谓何 谓予不信 谓词演算
危	危 危险 危机 危害 危急 危机感
莉	莉 莉莉 莉莉丝 莉雅 莉娅 莉斯
射	射 射击 射入 射雕 射进 射中
馆	馆 馆子 馆主 馆里 馆长 馆内
悉	悉 悉心 悉数 悉尼 悉心照料 悉听尊便
涛	涛 涛声 涛澜
鼻	鼻 鼻子 鼻梁 鼻涕 鼻血 鼻孔
兽	兽 兽医 兽皮 兽王 兽类 兽性
毒	毒 毒蛇 毒品 毒药 毒辣 毒素
绍	绍 绍兴 绍武 绍兴人 绍兴城 绍尔
治	治 治疗 治病 治愈 治安 治不好
瓶	瓶 瓶子 瓶颈 瓶盖 瓶瓶罐罐 瓶口
权	权 权利 权限 权力 权威 权势
朱	朱 朱雀 朱砂 朱家 朱颜 朱子
恋	恋 恋爱 恋人 恋恋不舍 恋情 恋恋
鸡	鸡 鸡蛋 鸡皮疙瘩 鸡腿 鸡血 鸡汤
诗	诗 诗人 诗歌 诗词 诗句 诗意
递	递 递给 递过来 递过去 递交 递出
讶	讶 讶异 讶然
防	防 防御 防止 防备 防守 防护
讨	讨 讨厌 讨论 讨好 讨价还价 讨伐
洞	洞 洞口 洞穴 洞府 洞天 洞穿
吼	吼 吼道 吼叫 吼声 吼吼 吼到
勇	勇 勇气 勇敢 勇士 勇者 勇猛
幻	幻 幻想 幻觉 幻影 幻化 幻听
瞪	瞪 瞪眼 瞪起 瞪视 瞪瞪 瞪住
彩	彩 彩票 彩虹 彩色 彩云 彩霞
梁	梁 梁山 梁平 梁海 梁家 梁柱
罢	罢 罢了 罢休 罢手 罢工 罢免
扫	扫 扫视 扫描 扫过 扫把 扫地
汗	汗 汗水 汗珠 汗颜 汗毛 汗流浃背
奔	奔 奔跑 奔驰 奔波 奔腾 奔驰车
妇	妇 妇女 妇人 妇产科 妇科 妇道人家
鲜	鲜 鲜血 鲜红 鲜花 鲜明 鲜艳
纯	纯 纯洁 纯粹 纯真 纯净 纯属
凉	凉 凉气 凉意 凉爽 凉风 凉快
素	素 素质 素养 素材 素描 素不相识
锋	锋 锋利 锋芒 锋锐 锋芒毕露 锋刃
冒	冒 冒出来 冒险 冒犯 冒汗 冒烟
辉	辉 辉煌 辉映 辉耀 辉光 辉煌灿烂
迹	迹 迹象 迹线 迹地
项	项 项目 项链 项羽 项目部 项目经理
丁	丁 丁丁 丁香 丁宁 丁点 丁磊
丁	丁 丁丁 丁香 丁宁 丁点 丁磊
职	职 职业 职位 职员 职责 职务
愤	愤 愤怒 愤愤 愤恨 愤愤不平 愤懑
努	努 努力 努力学习 努嘴 努力奋斗 努努嘴
罪	罪 罪恶 罪犯 罪过 罪魁祸首 罪名
爽	爽 爽快 爽朗 爽爽 爽歪歪 爽口
触	触 触动 触摸 触感 触发 触及
颗	颗 颗粒 颗粒无收 颗粒状 颗卫星 颗粒物
貌	貌 貌似 貌美 貌美如花 貌若天仙 貌不惊人
孤	孤 孤独 孤儿院 孤儿 孤单 孤零零
郭	郭 郭敬明 郭美美 郭文举 郭老板 郭富城
雄	雄 雄厚 雄伟 雄性 雄壮 雄鹰
概	概 概念 概率 概括 概要 概况
距	距 距离 距今 距离感 距离远 距今已有
抢	抢 抢劫 抢救 抢先 抢走 抢走了
傅	傅 傅先生 傅作义 傅里叶 傅思归 傅立叶
缘	缘 缘故 缘分 缘由 缘缘 缘份
烧	烧 烧烤 烧饼 烧焦 烧烤店 烧死
凯	凯 凯文 凯瑟琳 凯撒 凯旋 凯恩
盖	盖 盖住 盖子 盖亚 盖房子 盖世
炎	炎 炎热 炎黄 炎龙 炎炎 炎帝
琪	琪 琪琪 琪花 琪花瑶草
善	善 善良 善意 善于 善解人意 善恶
腾	腾 腾飞 腾空 腾龙 腾出 腾空而起
闲	闲 闲聊 闲着 闲逛 闲暇 闲来无事
徒	徒 徒弟 徒儿 徒劳 徒手 徒步
巧	巧 巧合 巧克力 巧妙 巧遇 巧夺天工
敌	敌 敌人 敌意 敌方 敌军 敌对
拾	拾 拾起 拾掇 拾荒 拾起来 拾荒者
免	免 免费 免得 免不了 免疫 免疫力
伴	伴 伴随 伴奏 伴侣 伴有 伴生
闷	闷 闷热 闷响 闷闷不乐 闷头 闷闷
稍	稍 稍微 稍稍 稍后 稍作 稍等一下
扭	扭 扭头 扭曲 扭动 扭过头 扭捏
倩	倩 倩影 倩女幽魂 倩女 倩况 倩人捉刀
秒	秒 秒钟 秒杀 秒针 秒左右 秒表
伯	伯 伯伯 伯父 伯母 伯爵 伯乐
零	零 零食 零花钱 零钱 零点 零件
凝	凝 凝聚 凝重 凝固 凝视着 凝结
灭	灭 灭亡 灭绝 灭掉 灭杀 灭绝师太
飘	飘 飘逸 飘荡 飘飘 飘过 飘落
略	略 略显 略带 略微 略有 略过
铭	铭 铭记 铭文 铭刻 铭牌 铭心
软	软 软件 软软 软弱 软绵绵 软磨硬泡
悄	悄 悄悄 悄悄的 悄然 悄悄地 悄无声息
挡	挡 挡住 挡不住 挡箭牌 挡风玻璃 挡路
轮	轮 轮回 轮廓 轮盘 轮胎 轮椅
川	川 川流不息 川静香 川菜馆 川菜 川原
番	番 番茄 番薯 番话 番茄酱 番号
优	优 优秀 优雅 优势 优美 优点
番	番 番茄 番薯 番话 番茄酱 番号
膀	膀 膀子 膀大腰圆 膀胱 膀阔腰圆 膀臂
膀	膀 膀子 膀大腰圆 膀胱 膀阔腰圆 膀臂
迟	迟 迟到 迟疑 迟迟 迟早 迟钝
犯	犯 犯罪 犯人 犯法 犯错 犯下
漫	漫 漫长 漫画 漫天 漫无目的 漫步
晃	晃 晃动 晃晃悠悠 晃悠 晃荡 晃晃
绿	绿 绿色 绿光 绿毛 绿油油 绿叶
吹	吹 吹牛 吹嘘 吹起 吹拂 吹动
拜	拜 拜托 拜拜 拜访 拜师 拜谢
残	残 残酷 残忍 残留 残破 残废
扑	扑 扑通 扑面而来 扑街 扑哧 扑克
玄	玄 玄武 玄妙 玄机 玄奥 玄学
董	董 董事长 董事 董事会 董卓 董家
惯	惯 惯性 惯例 惯用 惯犯 惯坏
诺	诺 诺基亚 诺言 诺诺 诺亚 诺克
启	启 启动 启明 启程 启蒙 启发
探	探 探索 探出 探测 探查 探讨
猫	猫 猫咪 猫猫 猫腻 猫眼 猫叫
妙	妙 妙龄少女 妙手 妙龄女子 妙用 妙不可言
偏	偏 偏偏 偏僻 偏远 偏向 偏瘦
亚	亚 亚洲 亚军 亚历克斯 亚当 亚东
宫	宫 宫殿 宫廷 宫中 宫主 宫本
傲	傲 傲气 傲慢 傲人 傲然 傲视
珠	珠 珠子 珠宝 珠宝店 珠珠 珠海
丫	丫 丫头 丫丫 丫鬟 丫子 丫环
灰	灰 灰色 灰尘 灰暗 灰蒙蒙 灰溜溜
肚	肚 肚子 肚皮 肚子饿 肚子疼 肚里
镇	镇 镇上 镇定 镇子 镇长 镇压
颤	颤 颤抖 颤动 颤颤巍巍 颤栗 颤巍巍
颤	颤 颤抖 颤动 颤颤巍巍 颤栗 颤巍巍
敬	敬 敬请 敬畏 敬佩 敬礼 敬酒
圆	圆 圆形 圆圆的 圆润 圆满 圆脸
昏	昏 昏迷 昏暗 昏倒 昏昏沉沉 昏睡
猜	猜 猜测 猜想 猜出 猜猜 猜中
咳	咳 咳嗽 咳嗽声 咳血 咳得 咳声
咳	咳 咳嗽 咳嗽声 咳血 咳得 咳声
厚	厚 厚厚的 厚重 厚实 厚道 厚着脸皮
皇	皇 皇帝 皇甫 皇上 皇子 皇宫
移	移 移动 移开 移民 移向 移植
粉	粉 粉丝 粉色 粉红色 粉笔 粉碎
维	维 维持 维护 维修 维度 维斯
博	博 博士 博物馆 博文 博得 博大精深
附	附 附近 附和 附身 附体 附带
尖	尖 尖叫 尖锐 尖叫声 尖子生 尖刀
抖	抖 抖动 抖动着 抖抖 抖落 抖擞
托	托 托人 托盘 托起 托付给 托关系
限	限 限制 限量版 限度 限于 限定
范	范 范围 范畴 范文 范蠡 范思哲
臂	臂 臂膀 臂力 臂弯 臂章 臂长
娜	娜 娜娜 娜塔莎 娜塔莉 娜拉 娜斯
爬	爬 爬起来 爬山 爬起 爬出来 爬上去
稳	稳 稳定 稳重 稳住 稳稳 稳定下来
奖	奖 奖励 奖金 奖学金 奖品 奖状
诚	诚 诚恳 诚实 诚意 诚心 诚信
娇	娇 娇小 娇羞 娇躯 娇嗔 娇嫩
归	归 归来 归于 归宿 归属 归功于
圣	圣 圣人 圣地 圣洁 圣光 圣诞节
共	共 共同 共有 共鸣 共和国 共享
欲	欲 欲望 欲哭无泪 欲言又止 欲裂 欲罢不能
际	际 际遇 际会 际涯 际会风云 际网路
输	输 输入 输给 输出 输赢 输液
虑	虑 虑无不周
敲	敲 敲门 敲门声 敲打 敲击 敲响
燕	燕 燕京 燕子 燕京大学 燕南 燕儿
绩	绩 绩效 绩溪 绩效考核 绩优股 绩效奖金
陌	陌 陌生 陌生人 陌生感 陌路 陌上桑
霸	霸 霸气 霸道 霸王 霸主 霸占
欺	欺 欺负 欺骗 欺负人 欺人太甚 欺凌
慌	慌 慌乱 慌张 慌忙 慌慌张张 慌不择路
扔	扔 扔掉 扔下 扔进 扔给 扔出
误	误 误会 误解 误以为 误伤 误打误撞
惹	惹 惹事 惹不起 惹怒 惹来 惹麻烦
获	获 获得 获取 获胜 获奖 获救
朵	朵 朵朵 朵花 朵玫瑰 朵儿 朵朵开
研	研 研究 研究生 研发 研究所 研制
姜	姜 姜文 姜子牙 姜汤 姜蒜 姜糖
姨	姨 姨妈 姨夫 姨父 姨娘 姨丈
凭	凭 凭借 凭着 凭空 凭借着 凭空出现
晕	晕 晕倒 晕过去 晕眩 晕死 晕乎乎
翼	翼 翼手龙 翼翼 翼展 翼城 翼翅
壮	壮 壮汉 壮硕 壮实 壮观 壮大
京	京 京城 京都 京华 京都大学 京剧
敏	敏 敏捷 敏感 敏锐 敏慧 敏锐地
骗	骗 骗子 骗人 骗过 骗局 骗钱
蒙	蒙 蒙面 蒙面人 蒙蒙亮 蒙蒙 蒙住
幽	幽 幽幽 幽灵 幽默 幽怨 幽暗
效	效 效果 效率 效益 效力 效应
森	森 森林 森然 森森 森严 森林公园
彻	彻 彻底 彻彻底底 彻头彻尾 彻底改变 彻夜
邪	邪 邪恶 邪气 邪门 邪神 邪风
邪	邪 邪恶 邪气 邪门 邪神 邪风
玲	玲 玲珑 玲玲 玲珑剔透 玲月 玲珑塔
省	省 省城 省会 省得 省心 省略
省	省 省城 省会 省得 省心 省略
琳	琳 琳娜 琳琅满目 琳琅 琳琅滿目 琳瑯满目
怨	怨 怨气 怨恨 怨念 怨言 怨毒
炸	炸 炸弹 炸开 炸药 炸裂 炸雷
鹏	鹏 鹏飞 鹏程 鹏城 鹏举 鹏道
测	测 测试 测验 测量 测评 测算
折	折 折磨 折腾 折叠 折断 折服
折	折 折磨 折腾 折叠 折断 折服
梅	梅 梅花 梅子 梅雨 梅洛 梅林
浑	浑 浑身 浑身上下 浑浑噩噩 浑浊 浑厚
搭	搭 搭理 搭讪 搭配 搭话 搭档
惨	惨 惨叫 惨白 惨叫声 惨不忍睹 惨烈
暖	暖 暖暖的 暖流 暖和 暖意 暖洋洋
洁	洁 洁白 洁癖 洁净 洁白如玉 洁白无瑕
瑶	瑶 瑶池 瑶琳 瑶家 瑶族 瑶台
童	童 童年 童话 童鞋 童子 童颜
苍	苍 苍白 苍老 苍蝇 苍穹 苍天
艺	艺 艺术 艺人 艺术家 艺术品 艺术系
嘻	嘻 嘻嘻 嘻嘻哈哈 嘻笑 嘻皮笑脸 嘻笑怒骂
砸	砸 砸死 砸出 砸碎 砸门 砸开
健	健 健康 健壮 健身 健硕 健身房
铃	铃 铃声 铃声响起 铃响 铃铛 铃木
绪	绪 绪论 绪言
扶	扶 扶住 扶起来 扶手 扶苏 扶持
扎	扎 扎进 扎根 扎实 扎眼 扎成
扎	扎 扎进 扎根 扎实 扎眼 扎成
尊	尊 尊敬 尊重 尊严 尊贵 尊称
匆	匆 匆匆 匆忙 匆匆忙忙 匆忙之间 匆促
沐	沐 沐阳 沐浴 沐浴露 沐川 沐浴液
鸣	鸣 鸣谢 鸣叫 鸣笛 鸣声 鸣叫声
甜	甜 甜美 甜蜜 甜甜的 甜甜 甜点
尼	尼 尼玛 尼克 尼尔 尼亚 尼姑
租	租 租房 租住 租金 租房子 租给
椅	椅 椅子 椅背 椅凳 椅垫 椅套
委	委 委屈 委员 委托 委婉 委员会
阶	阶 阶段 阶梯 阶级 阶层 阶梯教室
卷	卷 卷子 卷起 卷轴 卷发 卷入
尴	尴 尴尬 尴尬事
潇	潇 潇洒 潇潇 潇湘 潇潇洒洒 潇洒走
薇	薇 薇薇安 薇诺娜
戴	戴 戴眼镜 戴维斯 戴安娜 戴胜 戴帽子
净	净 净化 净土 净身 净赚 净水
政	政 政府 政治 政策 政教处 政委
仇	仇 仇恨 仇人 仇家 仇视 仇敌
仇	仇 仇恨 仇人 仇家 仇视 仇敌
猪	猪 猪头 猪肉 猪脚 猪八戒 猪哥
掏	掏 掏出 掏钱 掏空 掏心 掏耳朵
悲	悲 悲伤 悲剧 悲哀 悲痛 悲惨
浮	浮 浮现 浮云 浮出 浮躁 浮起
孔	孔 孔明 孔子 孔雀 孔林 孔丘
羞	羞 羞涩 羞辱 羞愧 羞红 羞耻
歉	歉 歉意 歉疚 歉然 歉收 歉仄
乌	乌 乌拉 乌黑 乌云 乌鸦 乌龟
财	财 财富 财产 财务 财神 财团
创	创 创造 创作 创业 创意 创建
胆	胆 胆子 胆小 胆怯 胆量 胆大
监	监 监狱 监控 监视 监考 监督
唉	唉 唉声叹气 唉呀 唉叹 唉唉叫 唉聲嘆氣
荡	荡 荡漾 荡然无存 荡起 荡气回肠 荡秋千
醉	醉 醉酒 醉意 醉汉 醉醺醺 醉人
录	录 录取 录像 录音 录制 录用
隔	隔 隔壁 隔离 隔绝 隔三差五 隔开
孟	孟 孟子 孟婆汤 孟家 孟阳 孟夫子
迅	迅 迅速 迅猛 迅雷不及掩耳之势 迅捷 迅雷不及掩耳
亡	亡 亡灵 亡魂 亡命 亡命之徒 亡者
育	育 育人 育才 育英 育种 育儿
尚	尚 尚未 尚可 尚且 尚有 尚书
织	织 织女 织成 织布 织毛衣 织田
康	康 康复 康泰 康宁 康健 康熙
晶	晶 晶莹 晶晶 晶莹剔透 晶体 晶石
踢	踢 踢飞 踢开 踢出 踢球 踢倒
恢	恢 恢复 恢复正常 恢复过来 恢复能力 恢弘
扯	扯 扯淡 扯开 扯远 扯住 扯掉
箱	箱 箱子 箱包 箱内 箱底 箱体
拖	拖 拖鞋 拖拉机 拖累 拖延 拖把
挣	挣 挣扎 挣脱 挣钱 挣开 挣到
降	降 降临 降低 降落 降下 降到
降	降 降临 降低 降落 降下 降到
史	史 史诗 史密斯 史蒂夫 史书 史无前例
裤	裤 裤子 裤兜 裤衩 裤裆 裤袋
轰	轰 轰鸣 轰然 轰鸣声 轰隆隆 轰动
涵	涵 涵养 涵盖 涵义 涵洞 涵蓄
尾	尾 尾巴 尾随 尾声 尾部 尾气
尾	尾 尾巴 尾随 尾声 尾部 尾气
侧	侧 侧身 侧面 侧目 侧门 侧耳
侧	侧 侧身 侧面 侧目 侧门 侧耳
侧	侧 侧身 侧面 侧目 侧门 侧耳
互	互 互相 互联网 互动 互相帮助 互不
磊	磊 磊磊 磊落 磊磊落落 磊落光明 磊落大方
芒	芒 芒果 芒果树 芒种 芒刺在背 芒刺
拒	拒 拒绝 拒之门外 拒人于千里之外 拒人千里 拒接
湖	湖 湖边 湖面 湖水 湖泊 湖里
预	预 预感 预料 预测 预言 预知
避	避 避免 避开 避讳 避雨 避让
乡	乡 乡下 乡村 乡巴佬 乡亲们 乡里
馨	馨 馨香 馨心
庄	庄 庄园 庄严 庄子 庄稼 庄重
耐	耐 耐心 耐不住 耐看 耐力 耐克
壁	壁 壁画 壁上 壁虎 壁纸 壁垒
拼	拼 拼命 拼搏 拼了命 拼死 拼音
裂	裂 裂缝 裂开 裂痕 裂纹 裂口
抗	抗 抗议 抗拒 抗衡 抗争 抗战
抹	抹 抹杀 抹布 抹掉 抹黑 抹抹
妍	妍 妍妍 妍丽 妍媸 妍姿艳质
懒	懒 懒得 懒腰 懒洋洋 懒散 懒懒
祖	祖 祖宗 祖国 祖上 祖先 祖传
锁	锁 锁定 锁上 锁链 锁住 锁好
凶	凶 凶手 凶狠 凶神恶煞 凶猛 凶恶
堆	堆 堆满 堆积 堆放 堆砌 堆起
施	施 施展 施主 施工 施舍 施法
缺	缺 缺少 缺点 缺乏 缺钱 缺陷
困	困 困难 困惑 困扰 困境 困住
贝	贝 贝尔 贝壳 贝斯 贝多芬 贝母
洪	洪 洪荒 洪水 洪亮 洪涛 洪流
慰	慰 慰藉 慰问 慰劳 慰问品 慰问金
暂	暂 暂时 暂且 暂停 暂时性 暂无
鼓	鼓 鼓励 鼓掌 鼓起 鼓起勇气 鼓鼓的
插	插 插入 插进 插嘴 插曲 插手
符	符 符合 符号 符咒 符箓 符合要求
蛇	蛇 蛇皮袋 蛇头 蛇王 蛇蝎 蛇皮
蛇	蛇 蛇皮袋 蛇头 蛇王 蛇蝎 蛇皮
乖	乖 乖乖 乖巧 乖宝宝 乖孩子 乖乖女
积	积 积分 积蓄 积累 积极 积攒
琴	琴 琴声 琴弦 琴棋书画 琴房 琴行
萌	萌 萌生 萌芽 萌动 萌发 萌渚岭
庭	庭 庭院 庭审 庭前 庭长 庭上
赚	赚 赚钱 赚取 赚大钱 赚了钱 赚头
赚	赚 赚钱 赚取 赚大钱 赚了钱 赚头
鞋	鞋 鞋子 鞋底 鞋带 鞋印 鞋跟
冬	冬 冬天 冬季 冬日 冬瓜 冬雪
卧	卧 卧室 卧槽 卧底 卧铺 卧龙
啪	啪 啪啪 啪嗒 啪啦 啪嚓 啪唧
熊	熊 熊猫 熊熊 熊熊燃烧 熊猫眼 熊瞎子
私	私 私人 私下 私自 私底下 私下里
梯	梯 梯子 梯田 梯队 梯云 梯形
瘦	瘦 瘦弱 瘦小 瘦子 瘦高 瘦瘦的
赏	赏 赏金 赏心悦目 赏识 赏脸 赏赐
农	农 农村 农民 农民工 农场 农活
饿	饿 饿死 饿狼 饿肚子 饿坏 饿死鬼
甩	甩 甩开 甩头 甩掉 甩手 甩出
陷	陷 陷入 陷阱 陷害 陷进 陷入困境
贴	贴 贴着 贴身 贴近 贴切 贴心
荣	荣 荣幸 荣耀 荣誉 荣华富贵 荣光
耀	耀 耀眼 耀武扬威 耀祖 耀星 耀华
营	营 营养 营业 营地 营养不良 营销
赌	赌 赌场 赌博 赌气 赌注 赌徒
豫	豫 豫州 豫南 豫北 豫剧 豫园
悔	悔 悔恨 悔过 悔意 悔改 悔不当初
庆	庆 庆幸 庆祝 庆元 庆贺 庆典
厂	厂 厂里 厂子 厂房 厂长 厂区
厂	厂 厂里 厂子 厂房 厂长 厂区
盛	盛 盛开 盛夏 盛世 盛大 盛行
盛	盛 盛开 盛夏 盛世 盛大 盛行
姓	姓 姓名 姓氏 姓李 姓张 姓林
脏	脏 脏兮兮 脏话 脏东西 脏乱 脏水
磨	磨 磨练 磨蹭 磨难 磨灭 磨磨
宣	宣 宣布 宣传 宣泄 宣告 宣扬
厨	厨 厨房 厨师 厨艺 厨子 厨师长
尤	尤 尤其 尤物 尤为 尤里 尤为重要
占	占 占据 占领 占地 占有 占卜
府	府 府邸 府上 府君 府城 府谷
针	针 针对 针灸 针头 针刺 针管
检	检 检查 检测 检查一下 检讨 检验
悦	悦 悦耳 悦来 悦乐 悦目 悦己者
含	含 含义 含笑 含泪 含糊不清 含有
脖	脖 脖子 脖颈 脖领子 脖子酸 脖颈子
郁	郁 郁闷 郁郁葱葱 郁郁 郁金香 郁郁寡欢
辛	辛 辛苦 辛辛苦苦 辛酸 辛勤 辛劳
播	播 播放 播报 播出 播音 播种
仁	仁 仁慈 仁兄 仁义 仁和 仁川
哲	哲 哲学 哲理 哲学家 哲学系 哲思
浓	浓 浓浓的 浓郁 浓烈 浓厚 浓重
碗	碗 碗筷 碗面 碗口 碗饭 碗碟
劳	劳 劳资 劳动 劳累 劳作 劳斯莱斯
吵	吵 吵醒 吵架 吵闹 吵闹声 吵杂
增	增 增加 增长 增强 增添 增多
泡	泡 泡妞 泡面 泡沫 泡汤 泡泡
琐	琐 琐琐碎碎 琐事 琐碎 琐屑 琐琐
亦	亦 亦然 亦可 亦步亦趋 亦非 亦师亦友
甲	甲 甲板 甲鱼 甲方 甲虫 甲壳虫
艾	艾 艾伦 艾迪 艾艾 艾利克 艾瑞克
季	季 季节 季末 季风 季明 季度
艾	艾 艾伦 艾迪 艾艾 艾利克 艾瑞克
伊	伊 伊人 伊东 伊丽莎白 伊莎贝拉 伊始
横	横 横扫 横行 横飞 横幅 横肉
怜	怜 怜悯 怜惜 怜爱 怜香惜玉 怜悯之心
偶	偶 偶尔 偶然 偶像 偶遇 偶然间
旭	旭 旭东 旭日 旭光 旭日东升 旭日初升
词	词 词语 词汇 词典 词曲 词穷
踏	踏 踏上 踏入 踏实 踏进 踏出
夕	夕 夕阳 夕阳西下 夕阳余晖 夕阳红 夕照
雾	雾 雾气 雾水 雾蒙蒙 雾里 雾霭
眯	眯 眯着 眯着眼 眯起 眯眼 眯缝
仍	仍 仍然 仍旧 仍旧会 仍停留 仍须努力
享	享 享受 享用 享福 享有 享誉
挤	挤 挤出 挤满 挤压 挤进 挤眉弄眼
惧	惧 惧怕 惧色 惧内 惧于 惧怯
脉	脉 脉搏 脉络 脉动 脉象 脉冲
悟	悟 悟空 悟性 悟道 悟出 悟出来
戒	戒 戒指 戒备 戒烟 戒心 戒掉
粗	粗 粗气 粗糙 粗壮 粗暴 粗大
鸟	鸟 鸟儿 鸟蛋 鸟语花香 鸟鸣 鸟窝
鸟	鸟 鸟儿 鸟蛋 鸟语花香 鸟鸣 鸟窝
绕	绕 绕过 绕道 绕开 绕过去 绕路
摔	摔 摔倒 摔死 摔坏 摔下来 摔了一跤
铺	铺 铺垫 铺满 铺天盖地 铺上 铺子
庞	庞 庞大 庞然大物 庞丽娜 庞德 庞杂
吞	吞 吞噬 吞吞吐吐 吞下 吞口水 吞咽
烂	烂 烂泥 烂摊子 烂尾楼 烂尾 烂醉
乔	乔 乔治 乔家 乔丹 乔布斯 乔林
袭	袭 袭击 袭警 袭击者 袭扰 袭取
刷	刷 刷牙 刷刷 刷卡 刷新 刷子
冥	冥 冥王 冥界 冥想 冥冥之中 冥冥中
爹	爹 爹娘 爹妈 爹爹 爹媽
楠	楠 楠木 楠竹 楠梓 楠溪江
臭	臭 臭小子 臭味 臭屁 臭骂 臭美
臭	臭 臭小子 臭味 臭屁 臭骂 臭美
丧	丧 丧尸 丧失 丧命 丧心病狂 丧气
冯	冯 冯宝宝 冯雪峰 冯家村 冯小刚 冯子材
痕	痕 痕迹 痕记 痕跡 痕垢 痕量
替	替 替代 替身 替换 替补 替人
莹	莹 莹莹 莹润 莹洁
厌	厌 厌恶 厌烦 厌倦 厌恶感 厌世
勾	勾 勾起 勾勒 勾搭 勾引 勾当
跃	跃 跃起 跃跃欲试 跃出 跃然 跃上
宗	宗 宗师 宗教 宗主 宗旨 宗派
朗	朗 朗诵 朗读 朗朗 朗声 朗朗乾坤
末	末 末日 末世 末了 末尾 末端
尝	尝 尝试 尝尝 尝到 尝到了 尝一尝
揉	揉 揉捏 揉搓 揉成一团 揉成 揉碎
阻	阻 阻止 阻挡 阻拦 阻碍 阻力
率	率 率先 率领 率性 率真 率直
率	率 率先 率领 率性 率真 率直
液	液 液体 液晶电视 液晶 液态 液晶屏
亏	亏 亏了 亏待 亏欠 亏损 亏得
忧	忧 忧伤 忧郁 忧愁 忧虑 忧心忡忡
评	评 评价 评论 评委 评估 评选
签	签 签约 签字 签名 签订 签下
趴	趴 趴在 趴下 趴着 趴着睡 趴倒
凤	凤 凤凰 凤毛麟角 凤凰山 凤眼 凤城
染	染 染红 染成 染上 染得 染指
缩	缩 缩小 缩回 缩短 缩成一团 缩脖子
融	融 融合 融入 融化 融洽 融为一体
泰	泰 泰山 泰国 泰坦 泰拳 泰勒
屏	屏 屏幕 屏障 屏蔽 屏住 屏风
屏	屏 屏幕 屏障 屏蔽 屏住 屏风
钢	钢 钢琴 钢铁 钢管 钢笔 钢筋
弯	弯 弯腰 弯曲 弯着腰 弯弯的 弯道
婉	婉 婉转 婉拒 婉约 婉言拒绝 婉言谢绝
款	款 款式 款款 款待 款项 款子
慧	慧 慧眼 慧根 慧心 慧眼识珠 慧星
列	列 列车 列表 列为 列车员 列入
艳	艳 艳丽 艳遇 艳阳高照 艳羡 艳阳
捂	捂 捂着 捂住 捂着脸 捂盖子
执	执 执行 执着 执意 执法 执拗
纳	纳 纳闷 纳米 纳入 纳凉 纳新
娃	娃 娃娃 娃子 娃儿 娃娃脸 娃娃亲
滑	滑 滑落 滑稽 滑动 滑行 滑倒
涌	涌 涌出 涌动 涌入 涌起 涌现
采	采 采访 采用 采取 采购 采集
黎	黎 黎明 黎川 黎阳 黎民 黎明前
赞	赞 赞同 赞叹 赞赏 赞美 赞许
旋	旋 旋转 旋即 旋律 旋风 旋涡
魏	魏 魏晋 魏国 魏先生 魏征 魏忠贤
脆	脆 脆弱 脆响 脆生生 脆皮 脆弱不堪
劫	劫 劫匪 劫持 劫难 劫色 劫后余生
熙	熙 熙熙攘攘 熙攘 熙来攘往 熙宁 熙春
遗	遗 遗憾 遗忘 遗传 遗产 遗迹
遗	遗 遗憾 遗忘 遗传 遗产 遗迹
撑	撑 撑起 撑不住 撑开 撑住 撑腰
姿	姿 姿势 姿态 姿色 姿容 姿式
赢	赢 赢得 赢家 赢钱 赢取 赢回来
丰	丰 丰富 丰满 丰盛 丰厚 丰收
拦	拦 拦住 拦下 拦截 拦不住 拦腰
狱	狱 狱警 狱中 狱长 狱卒 狱门
咯	咯 咯咯 咯噔 咯吱 咯吱咯吱 咯吱吱
咯	咯 咯咯 咯噔 咯吱 咯吱咯吱 咯吱吱
咯	咯 咯咯 咯噔 咯吱 咯吱咯吱 咯吱吱
咋	咋 咋样 咋办 咋啦 咋舌 咋个
咋	咋 咋样 咋办 咋啦 咋舌 咋个
薛	薛 薛宝钗 薛定谔 薛城 薛大哥 薛仁贵
宜	宜 宜阳 宜人 宜林 宜昌 宜家
摩	摩 摩托车 摩擦 摩托 摩挲 摩天轮
穷	穷 穷人 穷小子 穷鬼 穷酸 穷光蛋
珍	珍 珍惜 珍贵 珍珠 珍藏 珍宝
船	船 船上 船长 船舱 船员 船只
穆	穆 穆然 穆斯 穆林 穆尔 穆桂英
骑	骑 骑士 骑车 骑马 骑行 骑兵
迫	迫 迫不及待 迫切 迫于 迫不得已 迫使
夹	夹 夹杂着 夹杂 夹克 夹住 夹菜
夹	夹 夹杂着 夹杂 夹克 夹住 夹菜
旅	旅 旅游 旅馆 旅行 旅客 旅店
县	县 县城 县里 县长 县一中 县委
汪	汪 汪汪 汪洋 汪子 汪洋大海 汪汪叫
扰	扰 扰乱 扰人清梦 扰民 扰人 扰动
盒	盒 盒子 盒饭 盒里 盒盖 盒内
律	律 律师 律动 律法 律师费 律师证
屈	屈 屈服 屈辱 屈指可数 屈服于 屈膝
聪	聪 聪明 聪明人 聪慧 聪明伶俐 聪明才智
遥	遥 遥远 遥控器 遥不可及 遥遥 遥望
怡	怡 怡然 怡和 怡然自得 怡情 怡红
焦	焦 焦急 焦虑 焦点 焦躁 焦黑
溜	溜 溜达 溜走 溜溜 溜进 溜出
唇	唇 唇角 唇红齿白 唇瓣 唇膏 唇齿
坑	坑 坑人 坑坑洼洼 坑里 坑蒙拐骗 坑洞
妻	妻 妻子 妻儿 妻管严 妻妾 妻离子散
编	编 编辑 编号 编剧 编程 编制
驶	驶 驶去 驶来 驶过 驶向 驶出
塞	塞 塞进 塞满 塞入 塞进去 塞牙缝
撒	撒 撒娇 撒谎 撒旦 撒腿就跑 撒尿
肃	肃 肃穆 肃静 肃杀 肃然 肃然起敬
曹	曹 曹操 曹丕 曹操就到 曹雪芹 曹锟
逐	逐 逐渐 逐步 逐出 逐一 逐个
搬	搬 搬家 搬走 搬进 搬运 搬出
踪	踪 踪影 踪迹 踪迹诡秘
茫	茫 茫然 茫茫 茫茫人海 茫然无措 茫茫大海
跪	跪 跪下 跪倒 跪求 跪拜 跪地求饶
判	判 判断 判官 判定 判决 判若两人
喃	喃 喃喃 喃喃自语 喃喃地 喃喃细语 喃语
蒋	蒋 蒋家 蒋介石 蒋先生 蒋校长 蒋氏家族
栋	栋 栋梁 栋梁之才 栋梁之材 栋宇 栋梁材
摊	摊 摊位 摊子 摊开 摊主 摊前
龄	龄 龄期
篮	篮 篮球 篮球场 篮子 篮球队 篮筐
嘟	嘟 嘟囔 嘟嘟 嘟哝 嘟嘟囔囔 嘟嚷
泥	泥 泥土 泥巴 泥鳅 泥泞 泥水
吉	吉 吉他 吉利 吉祥 吉普车 吉安
倍	倍 倍感 倍儿 倍增 倍受 倍加
倾	倾 倾城 倾斜 倾国倾城 倾听 倾诉
喷	喷 喷出 喷嚏 喷涌 喷泉 喷出来
钻	钻 钻进 钻石 钻入 钻进去 钻心
掩	掩 掩饰 掩盖 掩护 掩埋 掩藏
捏	捏 捏住 捏紧 捏碎 捏死 捏着鼻子
键	键 键盘 键子 键入 键位 键不放
竹	竹 竹竿 竹林 竹子 竹简 竹叶
络	络 络绎不绝 络腮胡 络腮胡子 络腮 络绎
牵	牵 牵挂 牵扯 牵手 牵引 牵起
岳	岳 岳父 岳母 岳飞 岳家 岳不群
咕	咕 咕咕 咕噜 咕噜咕噜 咕嘟 咕噜噜
瑞	瑞 瑞士 瑞文 瑞士银行 瑞安 瑞雪
豆	豆 豆豆 豆腐 豆浆 豆子 豆腐脑
埋	埋 埋怨 埋头 埋伏 埋藏 埋葬
登	登 登上 登记 登陆 登时 登录
棍	棍 棍子 棍棒 棍儿 棍棒教育 棍道
肤	肤 肤色 肤浅 肤如凝脂 肤觉 肤轻松
殊	殊 殊不知 殊死 殊荣 殊途 殊途同归
翔	翔 翔宇 翔实 翔安 翔集 翔泳
恭	恭 恭喜 恭敬 恭恭敬敬 恭敬地 恭维
眨	眨 眨眼 眨巴 眨眼睛 眨动 眨巴眼
袁	袁 袁枚 袁天罡 袁世凯 袁姗姗 袁大头
旦	旦 旦夕 旦旦 旦夕祸福 旦角 旦夕之间
佩	佩 佩服 佩戴 佩剑 佩刀 佩带
帆	帆 帆布鞋 帆布 帆布包 帆船 帆布袋
拔	拔 拔出 拔腿就跑 拔掉 拔腿 拔出来
销	销 销售 销售员 销量 销毁 销魂
仰	仰 仰望 仰头 仰天 仰起 仰慕
狐	狐 狐狸 狐疑 狐狸精 狐朋狗友 狐仙
嘲	嘲 嘲笑 嘲讽 嘲弄 嘲笑声 嘲讽地
嘲	嘲 嘲笑 嘲讽 嘲弄 嘲笑声 嘲讽地
萱	萱 萱望 萱草 萱堂
寂	寂 寂静 寂寞 寂寥 寂灭 寂静无声
瞧	瞧 瞧瞧 瞧不起 瞧见 瞧一瞧 瞧不起人
逗	逗 逗我 逗乐 逗笑 逗逗 逗留
池	池 池塘 池子 池水 池里 池边
坤	坤 坤包 坤宁宫 坤车 坤角 坤宅
甘	甘 甘心 甘愿 甘甜 甘蔗 甘地
砰	砰 砰砰 砰然
燃	燃 燃烧 燃起 燃尽 燃料 燃眉之急
席	席 席卷 席子 席卷而来 席间 席地而坐
哇	哇 哇哇 哇塞 哇哇大哭 哇哇大叫 哇啦
振	振 振国 振华 振奋 振动 振作起来
叮	叮 叮嘱 叮咚 叮叮 叮当 叮叮当当
稀	稀 稀罕 稀少 稀奇 稀薄 稀里糊涂
嘉	嘉 嘉宾 嘉华 嘉泰 嘉奖 嘉陵
瓜	瓜 瓜子脸 瓜子 瓜葛 瓜果 瓜分
玛	玛 玛丽 玛莎拉蒂 玛瑙 玛雅 玛利亚
汤	汤 汤姆 汤圆 汤勺 汤汁 汤药
汤	汤 汤姆 汤圆 汤勺 汤汁 汤药
嫣	嫣 嫣然 嫣红 嫣然一笑 嫣然而笑 嫣红姹紫
踩	踩 踩到 踩油门 踩下 踩死 踩踏
趁	趁 趁着 趁机 趁早 趁现在 趁热
喘	喘 喘气 喘息 喘息声 喘气声 喘喘
痴	痴 痴迷 痴痴 痴情 痴呆 痴痴地
谷	谷 谷底 谷子 谷穗 谷主 谷梁
劝	劝 劝说 劝阻 劝解 劝劝 劝慰
谷	谷 谷底 谷子 谷穗 谷主 谷梁
纹	纹 纹身 纹路 纹丝不动 纹理 纹饰
驾	驾 驾驶 驾驶座 驾驶室 驾照 驾车
允	允 允许 允诺 允修 允从 允准
亿	亿 亿万 亿美元 亿元 亿美金 亿年
供	供 供奉 供应 供养 供给 供销社
僵	僵 僵尸 僵硬 僵持 僵住 僵局
芳	芳 芳香 芳心 芳名 芳草 芳华
颖	颖 颖慧 颖上 颖秀 颖悟 颖川
妮	妮 妮子 妮儿 妮娜 妮可 妮丝
域	域 域外 域名 域名服务 域名解析 域论
宽	宽 宽大 宽敞 宽阔 宽松 宽广
恼	恼 恼怒 恼火 恼羞成怒 恼人 恼恨
沫	沫 沫儿 沫子
鑫	鑫 鑫茂
肥	肥 肥胖 肥肉 肥猪 肥皂 肥大
询	询 询问 询问笔录 询问者 询问处 询查
拨	拨 拨通 拨打 拨开 拨弄 拨动
逛	逛 逛街 逛逛 逛一逛 逛商场 逛过
薄	薄 薄薄的 薄弱 薄雾 薄唇 薄荷
版	版 版本 版权 版面 版块 版图
厕	厕 厕所 厕所间 厕身 厕身其间 厕坑
途	途 途中 途径 途经 途上 途遇
批	批 批评 批准 批发 批判 批斗
蹲	蹲 蹲下 蹲下来 蹲坐在 蹲下去 蹲点
蹲	蹲 蹲下 蹲下来 蹲坐在 蹲下去 蹲点
恒	恒 恒星 恒心 恒丰 恒定 恒温
御	御 御用 御医 御寒 御使 御史
氛	氛 氛围 氛雾 氛云 氛圍
岩	岩 岩石 岩浆 岩壁 岩洞 岩层
宏	宏 宏伟 宏图 宏大 宏达 宏志
典	典 典型 典雅 典籍 典礼 典范
毁	毁 毁灭 毁掉 毁坏 毁容 毁灭性
祸	祸 祸害 祸水 祸国殃民 祸不单行 祸事
岚	岚 岚县 岚皋 岚山 岚皋县
夺	夺 夺走 夺取 夺目 夺得 夺回
猴	猴 猴子 猴儿 猴急 猴年马月 猴王
胳	胳 胳膊 胳膊肘 胳臂 胳肢窝 胳膊拧不过大腿
祝	祝 祝福 祝贺 祝愿 祝你好运 祝您
舅	舅 舅舅 舅妈 舅舅家 舅爷 舅母
撇	撇 撇嘴 撇撇嘴 撇开 撇下 撇清
潜	潜 潜力 潜意识 潜能 潜伏 潜入
欠	欠 欠揍 欠下 欠缺 欠条 欠扁
缠	缠 缠绕 缠绵 缠住 缠身 缠绕着
迪	迪 迪厅 迪拜 迪吧 迪伦 迪奥
辣	辣 辣椒 辣妹 辣子 辣子鸡 辣味
耗	耗 耗子 耗费 耗尽 耗时 耗着
航	航 航班 航空 航母 航行 航天
镖	镖 镖局 镖师 镖客 镖局子
媚	媚 媚眼 媚笑 媚态 媚惑 媚俗
泉	泉 泉水 泉眼 泉城 泉涌 泉下
岛	岛 岛国 岛上 岛屿 岛主 岛城
抵	抵 抵抗 抵挡 抵达 抵御 抵触
币	币 币种 币制 币值 币帛 币望
郎	郎 郎中 郎才女貌 郎君 郎当 郎朗
堪	堪 堪称 堪忧 堪舆 堪布 堪称一绝
咧	咧 咧嘴 咧着 咧嘴一笑 咧开 咧咧
酸	酸 酸痛 酸楚 酸酸的 酸涩 酸奶
桃	桃 桃花 桃子 桃木 桃树 桃园
焰	焰 焰火 焰火晚会 焰口 焰心 焰硝
瞎	瞎 瞎子 瞎说 瞎了眼 瞎扯 瞎逛
咖	咖 咖啡 咖啡厅 咖啡馆 咖啡店 咖啡色
咖	咖 咖啡 咖啡厅 咖啡馆 咖啡店 咖啡色
例	例 例外 例如 例子 例行 例会
购	购 购买 购物 购置 购物袋 购物中心
账	账 账号 账户 账单 账目 账本
夸	夸 夸张 夸奖 夸赞 夸大 夸夸其谈
曼	曼 曼妙 曼哈顿 曼陀罗 曼联 曼谷
遭	遭 遭遇 遭到 遭受 遭殃 遭罪
羊	羊 羊皮 羊肉 羊肉串 羊城 羊羔
奥	奥 奥迪 奥特曼 奥运会 奥迪车 奥秘
损	损 损失 损坏 损伤 损友 损害
征	征 征服 征兆 征战 征求 征程
唤	唤 唤醒 唤作 唤起 唤出 唤回
蹭	蹭 蹭蹬
赫	赫 赫然 赫赫有名 赫赫 赫伯特 赫拉
裙	裙 裙子 裙摆 裙装 裙边 裙裾
柜	柜 柜台 柜子 柜员 柜门 柜上
柜	柜 柜台 柜子 柜员 柜门 柜上
载	载 载体 载入 载人 载舟 载歌载舞
锅	锅 锅盖 锅碗瓢盆 锅铲 锅底 锅炉
辞	辞 辞职 辞退 辞去 辞掉 辞职信
扣	扣 扣子 扣除 扣动 扣扣 扣住
寝	寝 寝室 寝宫 寝食难安 寝具 寝食不安
伏	伏 伏羲 伏笔 伏特加 伏虎 伏击
棒	棒 棒棒糖 棒子 棒球 棒棒 棒球棒
猎	猎 猎人 猎物 猎豹 猎杀 猎魔
湿	湿 湿润 湿透 湿漉漉 湿湿的 湿气
咽	咽 咽下 咽喉 咽下去 咽不下 咽气
伍	伍 伍子胥 伍拾 伍先生 伍奢 伍元
皓	皓 皓月 皓然 皓齿 皓月当空 皓白
延	延 延伸 延续 延长 延迟 延年益寿
库	库 库里 库房 库存 库拉 库克
挠	挠 挠头 挠痒痒 挠痒 挠钩 挠秧
俗	俗 俗话说 俗称 俗人 俗话说得好 俗世
牧	牧 牧场 牧师 牧野 牧歌 牧羊犬
映	映 映入眼帘 映入 映衬 映照 映射
槽	槽 槽牙 槽糕 槽内 槽子 槽口
愧	愧 愧疚 愧对 愧色 愧不敢当 愧于
频	频 频繁 频道 频率 频频 频发
荒	荒 荒废 荒唐 荒凉 荒芜 荒野
吻	吻 吻合 吻上了 吻别 吻下去 吻痕
汽	汽 汽车 汽车站 汽水 汽油 汽笛声
舌	舌 舌头 舌尖 舌根 舌战 舌苔
虫	虫 虫子 虫鸣 虫儿 虫虫 虫草
莲	莲 莲花 莲蓬 莲藕 莲子 莲步
授	授 授权 授课 授予 授意 授业
贤	贤 贤惠 贤者 贤妻良母 贤淑 贤侄
档	档 档案 档次 档案袋 档子 档案室
捡	捡 捡起 捡起来 捡来 捡回来 捡破烂
仪	仪 仪器 仪式 仪表 仪容 仪表堂堂
吕	吕 吕布 吕洞宾 吕梁 吕蒙 吕不韦
赤	赤 赤裸裸 赤红 赤裸 赤色 赤脚
鸿	鸿 鸿蒙 鸿文 鸿志 鸿沟 鸿源
桥	桥 桥段 桥下 桥头 桥梁 桥洞
啸	啸 啸声 啸虎 啸叫 啸聚 啸傲
咚	咚 咚咚
诸	诸 诸葛 诸多 诸位 诸葛亮 诸如
撕	撕 撕裂 撕心裂肺 撕开 撕扯 撕碎
彼	彼 彼此 彼岸 彼此之间 彼得 彼岸花
繁	繁 繁华 繁星 繁荣 繁忙 繁琐
繁	繁 繁华 繁星 繁荣 繁忙 繁琐
浅	浅 浅浅的 浅笑 浅浅 浅蓝色 浅薄
浅	浅 浅浅的 浅笑 浅浅 浅蓝色 浅薄
啡	啡 啡厅
朴	朴 朴素 朴实 朴拙 朴实无华 朴树
兮	兮 兮兮
窝	窝 窝囊 窝囊废 窝里 窝火 窝头
赖	赖 赖床 赖账 赖皮 赖以生存 赖以
饱	饱 饱满 饱嗝 饱含 饱受 饱饱
炮	炮 炮弹 炮灰 炮火 炮仗 炮轰
炮	炮 炮弹 炮灰 炮火 炮仗 炮轰
洒	洒 洒脱 洒落 洒下 洒满 洒向
筑	筑 筑基 筑起 筑成 筑路 筑巢
润	润 润泽 润滑 润色 润湿 润滑油
乘	乘 乘客 乘坐 乘着 乘风 乘警
乘	乘 乘客 乘坐 乘着 乘风 乘警
塔	塔 塔米 塔顶 塔尔 塔林 塔克
搜	搜 搜索 搜寻 搜查 搜集 搜索引擎
饰	饰 饰品 饰演 饰物 饰品店 饰件
肌	肌 肌肉 肌肤 肌肉男 肌肉发达 肌体
协	协 协会 协议 协调 协助 协商
呃	呃 呃逆
缝	缝 缝隙 缝合 缝里 缝补 缝制
减	减 减少 减肥 减轻 减速 减弱
屑	屑 屑意
挨	挨 挨打 挨着 挨揍 挨个 挨骂
励	励 励志 励精图治 励志书 励行 励磁
砍	砍 砍刀 砍死 砍柴 砍掉 砍断
绑	绑 绑定 绑架 绑匪 绑住 绑起来
鼠	鼠 鼠标 鼠辈 鼠疫 鼠目寸光 鼠标垫
抛	抛 抛弃 抛开 抛下 抛出 抛向
耍	耍 耍赖 耍流氓 耍耍 耍起 耍宝
嫌	嫌 嫌弃 嫌疑人 嫌疑 嫌犯 嫌少
锐	锐 锐利 锐气 锐减 锐器 锐敏
饶	饶 饶命 饶有兴趣 饶有兴致 饶恕 饶有
丈	丈 丈夫 丈母娘 丈二和尚摸不着头脑 丈量 丈二和尚
扮	扮 扮演 扮演着 扮成 扮相 扮演者
州	州 州市 州长 州府 州立大学 州立
罚	罚 罚站 罚款 罚酒 罚单 罚抄
玻	玻 玻璃 玻璃窗 玻璃门 玻璃球 玻璃杯
扇	扇 扇门 扇子 扇动 扇风 扇形
眸	眸 眸子
蛮	蛮 蛮横 蛮子 蛮力 蛮荒 蛮不讲理
氏	氏 氏族 氏家谱 氏族谱 氏族社会 氏硬度
氏	氏 氏族 氏家谱 氏族谱 氏族社会 氏硬度
疗	疗 疗伤 疗养院 疗养 疗效 疗法
济	济 济南 济公 济源 济世 济州岛
瞳	瞳 瞳孔 瞳仁 瞳孔放大 瞳子 瞳人
售	售 售票员 售价 售货员 售楼 售票
澡	澡 澡堂 澡堂子 澡盆 澡池 澡房
郝	郝 郝老板 郝老爷 郝海东 郝大哥 郝大通
珊	珊 珊瑚 珊瑚礁 珊瑚树 珊瑚岛 珊瑚石
罩	罩 罩杯 罩住 罩子 罩不住 罩衣
哀	哀 哀嚎 哀求 哀伤 哀叹 哀怨
漠	漠 漠然 漠视 漠不关心 漠北 漠漠
鄙	鄙 鄙视 鄙夷 鄙人 鄙弃 鄙陋
兔	兔 兔子 兔崽子 兔肉 兔女郎 兔子不吃窝边草
益	益 益民 益处 益州 益气 益阳
祥	祥 祥和 祥云 祥瑞 祥林嫂 祥光
荐	荐 荐举 荐贤 荐引 荐任 荐拔
滋	滋 滋味 滋润 滋滋 滋生 滋养
斤	斤 斤斤计较 斤两 斤斤 斤数 斤半
径	径 径直 径自 径向 径路 径赛
纠	纠 纠结 纠缠 纠正 纠纷 纠葛
潘	潘 潘多拉 潘安 潘家园 潘玮柏 潘金莲
趟	趟 趟浑水 趟水 趟马 趟渾水
宾	宾 宾馆 宾利 宾客 宾主 宾主尽欢
串	串 串门 串联 串通 串串 串儿
妞	妞 妞妞 妞儿 妞子
泛	泛 泛起 泛红 泛黄 泛滥 泛白
鹰	鹰 鹰眼 鹰钩鼻 鹰爪 鹰隼 鹰嘴
诡	诡 诡异 诡秘 诡计 诡笑 诡谲
抚	抚 抚摸 抚养 抚平 抚慰 抚恤金
柱	柱 柱子 柱状 柱体 柱面 柱形
幅	幅 幅度 幅员辽阔 幅员 幅射 幅面
踹	踹 踹出去
汇	汇 汇报 汇聚 汇集 汇合 汇成
糟	糟 糟糕 糟蹋 糟老头子 糟心 糟粕
溪	溪 溪水 溪流 溪边 溪河 溪谷
苗	苗 苗条 苗子 苗苗 苗头 苗族
歪	歪 歪歪 歪着头 歪歪扭扭 歪头 歪歪斜斜
核	核 核心 核桃 核弹 核对 核实
吊	吊 吊儿郎当 吊灯 吊车 吊带 吊瓶
卓	卓 卓越 卓然 卓不凡 卓绝 卓尔不群
催	催 催促 催眠 催动 催命 催生
芸	芸 芸芸 芸芸众生 芸香 芸豆 芸香草
疲	疲 疲惫 疲倦 疲劳 疲惫不堪 疲累
姚	姚 姚明 姚安 姚家 姚木兰 姚滨
殿	殿 殿下 殿堂 殿内 殿外 殿后
奏	奏 奏效 奏响 奏凯 奏乐 奏鸣曲
腹	腹 腹部 腹诽 腹肌 腹中 腹地
添	添 添加 添麻烦 添油加醋 添乱 添置
忠	忠 忠诚 忠实 忠心 忠告 忠厚
链	链 链子 链接 链条 链断裂 链锁
侠	侠 侠客 侠义 侠士 侠盗 侠女
耸	耸 耸了耸肩 耸耸肩 耸立 耸了耸 耸肩
卵	卵 卵石 卵子 卵蛋 卵巢 卵形
脾	脾 脾气 脾气好 脾性 脾胃 脾脏
摄	摄 摄像头 摄像机 摄影 摄影师 摄像
烤	烤 烤肉 烤串 烤鱼 烤鸭 烤鸡
企	企 企业 企图 企鹅 企业家 企及
促	促 促使 促进 促销 促成 促狭
牢	牢 牢牢 牢房 牢骚 牢笼 牢固
逆	逆 逆转 逆流 逆风 逆境 逆来顺受
嫩	嫩 嫩嫩的 嫩白 嫩草 嫩芽 嫩绿
纵	纵 纵横 纵身 纵然 纵使 纵横交错
固	固 固定 固执 固然 固有 固体
彤	彤 彤云 彤云密布
箭	箭 箭头 箭矢 箭步 箭在弦上 箭法
迈	迈 迈着 迈出 迈步 迈开 迈进
伦	伦 伦敦 伦理 伦德尔 伦特 伦理道德
盟	盟 盟主 盟友 盟约 盟军 盟誓
蜜	蜜 蜜蜂 蜜糖 蜜桃 蜜月 蜜罐
订	订 订阅 订婚 订单 订好 订购
谋	谋 谋杀 谋生 谋划 谋面 谋害
贺	贺 贺喜 贺卡 贺兰 贺礼 贺电
审	审 审核 审讯 审视 审判 审问
胁	胁 胁迫 胁持 胁从 胁肩 胁制
葛	葛 葛云飞 葛根 葛优 葛朗台 葛先生
饮	饮 饮料 饮食 饮水机 饮酒 饮品
括	括 括号 括弧 括约肌 括在一起
括	括 括号 括弧 括约肌 括在一起
拐	拐 拐杖 拐角 拐角处 拐弯 拐进
嘀	嘀 嘀咕 嘀嘀 嘀嗒 嘀嘀咕咕 嘀里嘟噜
措	措 措手不及 措施 措辞 措词 措手
佑	佑 佑德 佑护 佑庇 佑助
愁	愁 愁眉苦脸 愁容 愁苦 愁绪 愁眉不展
魅	魅 魅力 魅惑 魅影 魅力值 魅力十足
爪	爪 爪子 爪牙 爪印 爪痕 爪哇
糖	糖 糖果 糖葫芦 糖醋排骨 糖糖 糖醋
悬	悬 悬崖 悬浮 悬挂 悬念 悬赏
哄	哄 哄笑 哄哄 哄堂大笑 哄笑声 哄骗
酷	酷 酷酷 酷热 酷爱 酷似 酷暑
漆	漆 漆黑 漆黑一片 漆皮 漆成 漆黑一团
闯	闯 闯荡 闯入 闯进 闯出 闯祸
策	策 策划 策略 策划案 策划书 策马
刑	刑 刑警 刑天 刑警队 刑侦 刑警大队
潮	潮 潮湿 潮流 潮红 潮水 潮水般
遮	遮 遮住 遮挡 遮掩 遮盖 遮挡住
齿	齿 齿轮 齿间 齿印 齿白 齿缝
丑	丑 丑陋 丑恶 丑八怪 丑小鸭 丑事
兜	兜 兜里 兜帽 兜兜 兜风 兜子
述	述 述说 述职 述說 述异记 述语
勉	勉 勉强 勉为其难 勉勉强强 勉励 勉力
钥	钥 钥匙 钥匙孔 钥匙扣 钥匙链 钥匙圈
盈	盈 盈盈 盈利 盈满 盈余 盈眶
序	序 序列 序幕 序章 序言 序号
斥	斥 斥责 斥候 斥力 斥骂 斥资
羡	羡 羡慕
渊	渊 渊源 渊博 渊海 渊深 渊明
匙	匙 匙子 匙里 匙吻鲟
匙	匙 匙子 匙里 匙吻鲟
申	申 申请 申屠 申明 申城 申请书
霜	霜 霜雪 霜降 霜冻 霜叶 霜天
培	培 培养 培训 培育 培训班 培养出来
刹	刹 刹车 刹那间 刹那 刹车声 刹住
刹	刹 刹车 刹那间 刹那 刹车声 刹住
笨	笨 笨蛋 笨拙 笨重 笨笨 笨手笨脚
鲁	鲁 鲁莽 鲁迅 鲁班 鲁国 鲁滨逊
贾	贾 贾宝玉 贾似道 贾老师 贾老板 贾斯丁
贾	贾 贾宝玉 贾似道 贾老师 贾老板 贾斯丁
隆	隆 隆起 隆重 隆隆 隆冬 隆盛
姬	姬 姬鹏飞 姬大哥 姬归汉 姬鼠 姬姓国
梓	梓 梓潼 梓树 梓潼县 梓官 梓匠
陶	陶 陶醉 陶瓷 陶然 陶渊明 陶罐
陶	陶 陶醉 陶瓷 陶然 陶渊明 陶罐
嚣	嚣 嚣张 嚣张气焰 嚣闹 嚣杂 嚣张一时
堵	堵 堵住 堵车 堵塞 堵死 堵墙
涩	涩 涩味 涩滞 涩谷 涩女郎
娱	娱 娱乐 娱乐圈 娱乐场所 娱乐活动 娱乐业
弥	弥 弥漫 弥补 弥漫着 弥勒佛 弥散
贱	贱 贱人 贱货 贱民 贱骨头 贱卖
麦	麦 麦克 麦克风 麦子 麦田 麦当劳
躯	躯 躯体 躯壳 躯干 躯骸 躯体虐待
谅	谅 谅解 谅山 谅必 谅已 谅察
袍	袍 袍子 袍哥 袍服 袍泽 袍褂
井	井 井盖 井井有条 井水 井然有序 井水不犯河水
尹	尹 尹志平 尹恩惠 尹师伯 尹师兄 尹克西
枝	枝 枝叶 枝头 枝条 枝桠 枝干
咒	咒 咒骂 咒语 咒文 咒怨 咒符
笼	笼 笼罩 笼子 笼罩着 笼统 笼络
乃	乃 乃是 乃至 乃至于 乃父 乃公
赔	赔 赔偿 赔钱 赔笑 赔罪 赔礼道歉
予	予 予以 予取予求 予取予夺 予付 予期
颇	颇 颇为 颇具 颇深 颇感 颇丰
崔	崔 崔判官 崔府君 崔真实 崔健 崔先生
蝶	蝶 蝶舞 蝶儿 蝶衣 蝶恋花 蝶泳
央	央 央求 央视 央行 央视春晚 央告
魄	魄 魄力 魄荡魂飞 魄散魂飞 魄荡魂摇 魄消魂散
魄	魄 魄力 魄荡魂飞 魄散魂飞 魄荡魂摇 魄消魂散
魄	魄 魄力 魄荡魂飞 魄散魂飞 魄荡魂摇 魄消魂散
寸	寸 寸头 寸土寸金 寸步难行 寸草不生 寸步不离
灿	灿 灿烂 灿若繁星 灿然 灿烂辉煌 灿烂微笑
憋	憋 憋屈 憋着 憋不住 憋死 憋住
萝	萝 萝卜 萝卜丝 萝卜头 萝卜干 萝卜青菜
幼	幼 幼儿园 幼稚 幼小 幼年 幼时
忌	忌 忌惮 忌讳 忌日 忌口 忌妒
巷	巷 巷子 巷口 巷道 巷子口 巷里
巷	巷 巷子 巷口 巷道 巷子口 巷里
漏	漏 漏出 漏洞 漏掉 漏水 漏出来
邀	邀 邀请 邀请函 邀约 邀功 邀请卡
歹	歹 歹徒 歹毒 歹人 歹心 歹意
泄	泄 泄露 泄气 泄漏 泄愤 泄密
彪	彪 彪悍 彪形大汉 彪形 彪壮 彪炳
涨	涨 涨红 涨红了脸 涨价 涨停 涨涨
霞	霞 霞光 霞山 霞飞路 霞衣 霞彩
墓	墓 墓碑 墓地 墓穴 墓室 墓园
韵	韵 韵味 韵诗 韵律 韵事 韵母
垃	垃 垃圾 垃圾桶 垃圾堆 垃圾箱 垃圾场
涂	涂 涂抹 涂山 涂鸦 涂料 涂成
霍	霍 霍先生 霍然 霍金 霍元甲 霍霍
召	召 召唤 召集 召开 召唤师 召唤兽
召	召 召唤 召集 召开 召唤师 召唤兽
裹	裹 裹住 裹得 裹挟 裹紧 裹成
斜	斜 斜眼 斜阳 斜靠 斜坡 斜对面
构	构 构成 构思 构造 构建 构想
泣	泣 泣不成声 泣鬼神 泣血 泣诉 泣涕
邓	邓 邓大人 邓丽君 邓肯 邓稼先 邓夫人
讽	讽 讽刺 讽喻 讽刺性 讽刺话 讽刺作品
媳	媳 媳妇 媳妇儿 媳婦
拽	拽 拽了起来 拽起来
拽	拽 拽了起来 拽起来
挖	挖 挖掘 挖出来 挖苦 挖出 挖掘机
逝	逝 逝去 逝世 逝者 逝水 逝者如斯
袖	袖 袖子 袖口 袖手旁观 袖珍 袖章
阅	阅 阅读 阅历 阅览室 阅兵 阅览
疾	疾 疾病 疾驰 疾步 疾风 疾速
呐	呐 呐喊 呐喊声 呐喊助威 呐喊助阵
斩	斩 斩杀 斩钉截铁 斩断 斩妖 斩首
刃	刃 刃口 刃具 刃锋 刃磨 刃儿
植	植 植物 植入 植被 植物园 植株
帽	帽 帽子 帽檐 帽沿 帽徽 帽儿
瑟	瑟 瑟瑟 瑟斯 瑟缩 瑟缩着 瑟瑟秋风
巾	巾 巾帼 巾帼不让须眉 巾帼英雄 巾帼须眉 巾帕
坦	坦 坦然 坦克 坦白 坦诚 坦途
赋	赋 赋予 赋诗 赋闲在家 赋有 赋税
雕	雕 雕刻 雕像 雕塑 雕琢 雕花
删	删 删除 删了 删掉 删去 删减
宅	宅 宅子 宅院 宅基地 宅邸 宅门
诱	诱 诱惑 诱人 诱惑力 诱饵 诱导
恰	恰 恰好 恰巧 恰恰 恰到好处 恰当
嫂	嫂 嫂子 嫂嫂 嫂夫人
岂	岂 岂不是 岂能 岂有此理 岂料 岂止
截	截 截然不同 截然 截止 截拳道 截住
愈	愈 愈发 愈合 愈加 愈来愈 愈演愈烈
蹦	蹦 蹦蹦跳跳 蹦出 蹦出来 蹦跳 蹦蹦
渣	渣 渣滓 渣子 渣土 渣打 渣滓洞
匪	匪 匪徒 匪夷所思 匪首 匪气 匪类
莎	莎 莎士比亚 莎拉 莎翁 莎车 莎草
莎	莎 莎士比亚 莎拉 莎翁 莎车 莎草
厢	厢 厢房 厢式 厢间 厢式车
誓	誓 誓言 誓死 誓不罢休 誓约 誓师大会
嗓	嗓 嗓子 嗓音 嗓门 嗓子眼 嗓子眼儿
崩	崩 崩溃 崩塌 崩坏 崩裂 崩盘
筋	筋 筋骨 筋疲力尽 筋脉 筋肉 筋斗
噗	噗 噗嗤 噗通 噗嗤一声 噗哧 噗通一声
柯	柯 柯林 柯蒂斯 柯尔特 柯察金 柯达
翠	翠 翠绿 翠绿色 翠竹 翠玉 翠莲
聂	聂 聂远 聂荣 聂耳 聂聂 聂荣县
匕	匕 匕首 匕鬯不惊
昂	昂 昂贵 昂首挺胸 昂起 昂首 昂扬
谭	谭 谭家 谭新杰 谭盾 谭嗣同 谭家菜
吾	吾 吾辈 吾主 吾王 吾子 吾爱
衫	衫 衫衣 衫裤 衫袖 衫林
豹	豹 豹子 豹纹 豹子胆 豹头环眼 豹子头
嫁	嫁 嫁给 嫁人 嫁不出去 嫁衣 嫁出去
盗	盗 盗版 盗墓 盗贼 盗窃 盗取
浴	浴 浴室 浴巾 浴缸 浴袍 浴池
麟	麟 麟儿 麟德 麟角 麟游 麟趾呈祥
猥	猥 猥琐 猥琐男 猥亵 猥亵妇女 猥亵行为
盾	盾 盾牌 盾片 盾状 盾皮鱼类 盾板
勤	勤 勤奋 勤快 勤劳 勤工俭学 勤勤恳恳
宙	宙 宙斯
诧	诧 诧异 诧然 诧愕
枚	枚 枚举 枚举法
违	违 违背 违反 违法 违规 违抗
穴	穴 穴位 穴道 穴居人 穴处 穴居
贼	贼 贼眉鼠眼 贼人 贼眼 贼溜溜 贼亮
煞	煞 煞气 煞白 煞笔 煞是好看 煞星
骚	骚 骚扰 骚动 骚乱 骚气 骚货
裁	裁 裁判 裁决 裁缝 裁员 裁剪
娟	娟 娟子 娟秀 娟好
惠	惠 惠顾 惠子 惠及 惠民 惠风和畅
旗	旗 旗下 旗袍 旗帜 旗子 旗杆
樱	樱 樱花 樱桃 樱桃小嘴 樱唇 樱花树
廊	廊 廊道 廊桥 廊坊 廊柱 廊庙
页	页 页面 页码 页数 页岩 页页
锦	锦 锦囊 锦盒 锦绣 锦城 锦衣卫
详	详 详细 详情 详细情况 详细资料 详谈
硕	硕 硕大 硕士 硕士学位 硕大无比 硕士生
辱	辱 辱骂 辱没 辱命 辱国 辱没门庭
垂	垂 垂下 垂头丧气 垂直 垂涎 垂落
躁	躁 躁动 躁动不安 躁狂 躁热 躁狂症
榜	榜 榜单 榜样 榜首 榜眼 榜上有名
恍	恍 恍惚 恍然大悟 恍然 恍若 恍恍惚惚
卢	卢 卢卡 卢卡斯 卢瑟 卢布 卢浮宫
桶	桶 桶子 桶装 桶装水 桶盖 桶状
搂	搂 搂住 搂搂抱抱 搂抱 搂入 搂搂
劈	劈 劈头盖脸 劈开 劈成 劈柴 劈叉
覆	覆 覆盖 覆灭 覆盖住 覆辙 覆手为雨
捉	捉 捉弄 捉住 捉迷藏 捉摸不透 捉妖
啤	啤 啤酒 啤酒瓶 啤酒肚 啤酒罐 啤酒厂
割	割 割舍 割破 割开 割断 割草
衡	衡 衡量 衡山 衡南 衡水 衡量标准
讯	讯 讯息 讯号 讯问 讯雷 讯通
衬	衬 衬衫 衬衣 衬托 衬托出 衬出
冠	冠 冠军 冠冕堂皇 冠以 冠玉 冠名
描	描 描述 描写 描绘 描绘出 描画
篇	篇 篇文章 篇章 篇幅 篇篇 篇名
吟	吟 吟唱 吟诗 吟诵 吟诗作对 吟游
霖	霖 霖生 霖雨
盆	盆 盆子 盆栽 盆地 盆景 盆花
跌	跌 跌倒 跌落 跌跌撞撞 跌入 跌宕起伏
茹	茹 茹毛饮血 茹素 茹费理 茹苦含辛 茹尔宾
艰	艰 艰难 艰辛 艰苦 艰巨 艰苦奋斗
勒	勒 勒索 勒住 勒令 勒紧 勒死
叨	叨 叨叨 叨念 叨扰 叨咕 叨唠
叨	叨 叨叨 叨念 叨扰 叨咕 叨唠
碍	碍 碍于 碍事 碍眼 碍于面子 碍手碍脚
棋	棋 棋子 棋盘 棋局 棋艺 棋牌室
俏	俏 俏皮 俏丽 俏生生 俏皮话 俏佳人
丛	丛 丛林 丛生 丛林中 丛中 丛里
孝	孝 孝顺 孝敬 孝心 孝子 孝敬父母
烁	烁 烁烁
啧	啧 啧啧 啧啧称奇 啧啧称赞 啧啧声 啧啧称羡
冉	冉 冉冉 冉冉升起 冉冉上升 冉阿让 冉兴让
侯	侯 侯爵 侯赛因 侯车 侯德榜 侯公子
抑	抑 抑制 抑郁 抑或 抑郁症 抑扬顿挫
疤	疤 疤痕 疤脸 疤瘌 疤瘌眼 疤印
茜	茜 茜茜公主 茜草 茜素
茜	茜 茜茜公主 茜草 茜素
洲	洲 洲际 洲际导弹 洲头 洲际性 洲界
砖	砖 砖头 砖块 砖瓦房 砖瓦 砖石
琦	琦 琦玉县
荷	荷 荷尔蒙 荷花 荷包 荷叶 荷包蛋
哗	哗 哗哗 哗啦啦 哗啦 哗然 哗啦哗啦
灾	灾 灾难 灾祸 灾星 灾害 灾变
霄	霄 霄汉 霄夜 霄壤之别 霄壤
矮	矮 矮小 矮子 矮胖 矮个子 矮个
贪	贪 贪婪 贪玩 贪心 贪官 贪图
返	返 返回 返修 返校 返老还童 返程
廖	廖 廖国强 廖先生 廖耀湘 廖化作先锋 廖仲恺
颊	颊 颊骨 颊面 颊上添毫 颊须 颊车
婶	婶 婶婶 婶子 婶娘 婶母 婶婆
皆	皆 皆知 皆大欢喜 皆惊 皆空 皆宜
沿	沿 沿着 沿海 沿途 沿路 沿街
掐	掐 掐着 掐住 掐死 掐灭 掐指一算
沾	沾 沾满 沾染 沾沾自喜 沾边 沾湿
披	披 披肩 披着 披上 披散 披风
仓	仓 仓库 仓促 仓鼠 仓皇 仓惶
霉	霉 霉运 霉味 霉头 霉气 霉菌
奕	奕 奕奕
莱	莱 莱克 莱斯 莱尔 莱德 莱文
锻	锻 锻炼 锻炼身体 锻造 锻练 锻打
挽	挽 挽着 挽留 挽回 挽起 挽救
阁	阁 阁下 阁楼 阁主 阁老 阁子
炒	炒 炒菜 炒股 炒饭 炒鱿鱼 炒作
淋	淋 淋漓尽致 淋湿 淋漓 淋雨 淋浴
凳	凳 凳子
耻	耻 耻辱 耻笑 耻辱感 耻骨 耻辱柱
腕	腕 腕表 腕上 腕带 腕力 腕子
籍	籍 籍贯 籍无名 籍口 籍贯地 籍没
矩	矩 矩阵 矩形 矩形框 矩尺 矩形网格
拆	拆 拆开 拆迁 拆穿 拆散 拆掉
拆	拆 拆开 拆迁 拆穿 拆散 拆掉
竞	竞 竞争 竞选 竞争对手 竞技 竞赛
析	析 析出 析产 析木 析疑 析交离亲
哑	哑 哑巴 哑口无言 哑然 哑然失笑 哑铃
蓉	蓉 蓉蓉 蓉城 蓉园 蓉树
谦	谦 谦虚 谦卑 谦让 谦和 谦逊
宠	宠 宠物 宠爱 宠物店 宠儿 宠物狗
眠	眠 眠思梦想 眠药 眠花宿柳 眠尔通 眠山
邵	邵 邵东 邵阳 邵雍 邵康节 邵逸夫
腐	腐 腐烂 腐蚀 腐朽 腐败 腐肉
慨	慨 慨叹 慨然 慨然应允 慨当以慷 慨然允诺
捕	捕 捕捉到 捕捉 捕鱼 捕猎 捕获
胎	胎 胎记 胎儿 胎盘 胎死腹中 胎气
糕	糕 糕点 糕点店 糕饼 糕饼店 糕干
戚	戚 戚戚 戚继光 戚戚然 戚戚焉 戚友
灌	灌 灌输 灌木丛 灌木 灌入 灌溉
桐	桐 桐树 桐城 桐子 桐油 桐木
逍	逍 逍遥 逍遥子 逍遥自在 逍遥法外 逍遥派
彬	彬 彬彬有礼 彬彬 彬县
献	献 献给 献殷勤 献媚 献血 献上
桑	桑 桑塔纳 桑拿 桑葚 桑树 桑叶
碧	碧 碧绿 碧海 碧水 碧蓝 碧玉
械	械 械斗 械弹 械器
翘	翘 翘起 翘着 翘楚 翘起来 翘首
渴	渴 渴望 渴求 渴死 渴得 渴盼
辑	辑 辑录 辑要 辑佚 辑印 辑书
侵	侵 侵蚀 侵犯 侵入 侵袭 侵略
瞒	瞒 瞒不过 瞒过 瞒不住 瞒天过海 瞒住
咔	咔 咔嚓 咔哒 咔嗒 咔叽 咔喳
岸	岸 岸边 岸上 岸线 岸堤 岸然
沟	沟 沟通 沟壑 沟里 沟渠 沟通交流
捧	捧 捧起 捧场 捧腹大笑 捧住 捧腹
枯	枯 枯燥 枯萎 枯黄 枯竭 枯叶
氓	氓 氓流
邻	邻 邻居 邻家 邻居家 邻里 邻村
筒	筒 筒子楼 筒子 筒裙 筒裤 筒状
驰	驰 驰骋 驰名 驰骋疆场 驰名中外 驰骋纵横
妥	妥 妥协 妥当 妥善 妥帖 妥妥当当
铜	铜 铜钱 铜铃 铜镜 铜币 铜山
坠	坠 坠落 坠入 坠落在 坠子 坠下
蔡	蔡 蔡伦 蔡夫人 蔡大爷 蔡依林 蔡国庆
愉	愉 愉快 愉悦 愉悦感 愉色 愉悅
谱	谱 谱写 谱子 谱曲 谱儿 谱仪
鼎	鼎 鼎盛 鼎鼎大名 鼎鼎有名 鼎力支持 鼎盛时期
嘶	嘶 嘶吼 嘶哑 嘶鸣 嘶喊 嘶叫
乞	乞 乞丐 乞讨 乞儿 乞求 乞讨者
膝	膝 膝盖 膝下 膝关节 膝盖骨 膝头
畏	畏 畏惧 畏畏缩缩 畏缩 畏首畏尾 畏罪潜逃
契	契 契约 契合 契机 契约书 契诃夫
契	契 契约 契合 契机 契约书 契诃夫
熬	熬 熬夜 熬到 熬过 熬过来 熬不住
杆	杆 杆子 杆秤 杆儿 杆状 杆菌
绵	绵 绵绵 绵延 绵羊 绵长 绵软
奉	奉 奉献 奉承 奉还 奉劝 奉命
卦	卦 卦象 卦辞 卦师 卦书 卦意
亭	亭 亭子 亭亭玉立 亭台楼阁 亭亭 亭台
筷	筷 筷子 筷子巷
瞄	瞄 瞄准 瞄着 瞄向 瞄到 瞄准镜
骄	骄 骄傲 骄阳 骄傲地 骄阳似火 骄女
睿	睿 睿智 睿哲 睿明 睿宗 睿智者
畅	畅 畅快 畅想 畅谈 畅游 畅销
颠	颠 颠簸 颠覆 颠倒 颠颠 颠沛流离
噬	噬 噬人鲨 噬脐莫及 噬菌体
玫	玫 玫瑰 玫瑰花 玫瑰色 玫瑰红 玫瑰园
抄	抄 抄起 抄袭 抄写 抄抄 抄近路
寿	寿 寿命 寿司 寿终正寝 寿星 寿衣
撤	撤 撤退 撤离 撤销 撤掉 撤回
痒	痒 痒痒 痒酥酥 痒觉 痒生
肆	肆 肆无忌惮 肆意 肆虐 肆意妄为 肆意挥霍
叉	叉 叉腰 叉子 叉叉 叉开 叉烧
卿	卿 卿卿 卿卿我我 卿本佳人 卿大夫 卿士
阔	阔 阔别 阔少 阔绰 阔气 阔步
苹	苹 苹果 苹果树 苹果公司 苹果电脑 苹果汁
填	填 填饱 填写 填满 填补 填好
驱	驱 驱使 驱散 驱赶 驱逐 驱车
姆	姆 姆妈 姆指 姆林宫 姆莱 姆斯基
党	党 党员 党委书记 党委 党派 党校
怔	怔 怔怔 怔住 怔忡
瞅	瞅 瞅见
竖	竖 竖起 竖立 竖直 竖子 竖立起来
兑	兑 兑换 兑现 兑奖 兑换券 兑换率
均	均 均匀 均衡 均价 均线 均分
症	症 症状 症结 症候群 症结所在 症候
旺	旺 旺盛 旺旺 旺季 旺夫 旺角
碌	碌 碌碌无为 碌碌 碌碡 碌碌无能 碌碌无闻
慎	慎 慎重 慎重考虑 慎行 慎用 慎之又慎
虹	虹 虹膜 虹桥 虹桥机场 虹口 虹彩
蠢	蠢 蠢蠢欲动 蠢货 蠢事 蠢蠢 蠢蛋
虹	虹 虹膜 虹桥 虹桥机场 虹口 虹彩
吱	吱 吱吱 吱呀 吱声 吱呀呀 吱吱作响
吱	吱 吱吱 吱呀 吱声 吱呀呀 吱吱作响
姥	姥 姥姥 姥爷 姥姥家 姥娘
姥	姥 姥姥 姥爷 姥姥家 姥娘
尿	尿 尿裤子 尿急 尿床 尿意 尿布
绳	绳 绳子 绳索 绳之以法 绳结 绳梯
栏	栏 栏杆 栏目 栏目组 栏栅 栏内
妆	妆 妆扮 妆点 妆模作样 妆台 妆饰
乾	乾 乾坤 乾隆 乾坤袋 乾隆皇帝 乾冰
乾	乾 乾坤 乾隆 乾坤袋 乾隆皇帝 乾冰
萍	萍 萍水相逢 萍踪侠影 萍踪 萍水 萍乡
港	港 港口 港湾 港币 港岛 港城
崇	崇 崇拜 崇尚 崇高 崇敬 崇祯
仗	仗 仗义 仗势欺人 仗势 仗义执言 仗义疏财
狸	狸 狸猫 狸子 狸猫换
闺	闺 闺女 闺房 闺中 闺阁 闺秀
吩	吩 吩咐
稿	稿 稿子 稿费 稿件 稿纸 稿酬
嚷	嚷 嚷嚷 嚷起来 嚷叫 嚷声 嚷出去
盼	盼 盼望 盼望着 盼头 盼星星 盼望已久
伐	伐 伐木 伐毛洗髓 伐木工人 伐木场 伐木工
偿	偿 偿还 偿命 偿还债务 偿付 偿债
辜	辜 辜负 辜鸿铭 辜恩背义 辜负希望 辜恩负义
淑	淑 淑女 淑芳 淑珍 淑静 淑媛
彭	彭 彭山 彭长老 彭泽 彭州 彭祖
谨	谨 谨慎 谨记 谨小慎微 谨以 谨防
阎	阎 阎王 阎罗王 阎罗 阎王爷 阎王殿
贫	贫 贫穷 贫道 贫困 贫民区 贫僧
殷	殷 殷勤 殷红 殷实 殷切 殷鉴
邦	邦 邦杰 邦国 邦德 邦迪 邦交
帘	帘 帘子 帘布 帘幕 帘帐 帘子布
著	著 著名 著称 著作 著名作家 著名景点
驳	驳 驳回 驳斥 驳杂 驳倒 驳壳枪
窜	窜 窜出 窜进 窜入 窜逃 窜升
摘	摘 摘下 摘下来 摘掉 摘星 摘自
慈	慈 慈祥 慈爱 慈善 慈眉善目 慈悲
鹤	鹤 鹤立鸡群 鹤发童颜 鹤鸣 鹤发 鹤望兰
巫	巫 巫师 巫术 巫女 巫婆 巫山
邹	邹 邹城 邹家 邹衍 邹县 邹平
跨	跨 跨越 跨过 跨出 跨步 跨上
喉	喉 喉咙 喉结 喉头 喉管 喉部
憾	憾 憾事 憾动 憾恨
佣	佣 佣兵 佣人 佣兵团 佣金 佣工
嚎	嚎 嚎叫 嚎啕大哭 嚎叫声 嚎哭 嚎啕
宴	宴 宴会 宴席 宴请 宴会厅 宴客
寄	寄 寄托 寄宿 寄生 寄主 寄给
瞥	瞥 瞥见 瞥一眼 瞥视 瞥見
刮	刮 刮目相看 刮起 刮过 刮得 刮风下雨
矿	矿 矿泉水 矿泉水瓶 矿石 矿工 矿区
谎	谎 谎言 谎话 谎称 谎报 谎骗
婴	婴 婴儿 婴孩 婴儿车 婴儿床 婴幼儿
污	污 污染 污垢 污秽 污渍 污蔑
础	础 础润而雨 础石
蚁	蚁 蚁后 蚁王 蚁穴 蚁巢 蚁窝
尺	尺 尺寸 尺子 尺度 尺码 尺素
俱	俱 俱乐部 俱全 俱佳 俱往 俱备
侃	侃 侃侃而谈 侃大山 侃侃 侃价 侃山
坛	坛 坛子 坛主 坛坛罐罐 坛友 坛场
胃	胃 胃口 胃部 胃病 胃癌 胃酸
萨	萨 萨斯 萨尔 萨摩耶 萨克斯 萨拉
捷	捷 捷径 捷达 捷足先登 捷安特 捷达车
柏	柏 柏油路 柏油 柏林 柏树 柏拉图
柄	柄 柄竹 柄政
柴	柴 柴火 柴刀 柴米油盐 柴油 柴禾
腻	腻 腻歪 腻味 腻在一起 腻腻歪歪 腻着
扩	扩 扩大 扩散 扩张 扩展 扩音器
侣	侣 侣伴
嘱	嘱 嘱咐 嘱托 嘱告 嘱令 嘱目
挪	挪 挪动 挪开 挪移 挪不开 挪威
涯	涯 涯子 涯际
陵	陵 陵墓 陵园 陵寝 陵川 陵水
肿	肿 肿胀 肿瘤 肿起 肿起来 肿块
浸	浸 浸湿 浸泡 浸透 浸染 浸入
腔	腔 腔调 腔子 腔道 腔儿 腔体
诀	诀 诀窍 诀别 诀要 诀别书
厦	厦 厦门 厦大 厦门大学 厦门岛 厦华
厦	厦 厦门 厦大 厦门大学 厦门岛 厦华
懵	懵 懵懂 懵懵懂懂 懵懵 懵然 懵然无知
辕	辕 辕马 辕门
雀	雀 雀跃 雀斑 雀儿 雀鸟 雀跃不已
访	访 访问 访客 访谈 访友 访华
拟	拟 拟定 拟态 拟人 拟人化 拟声词
患	患 患者 患有 患上 患得患失 患病
誉	誉 誉为 誉满 誉满天下 誉满全球 誉满全国
矛	矛 矛盾 矛头 矛盾体 矛盾激化 矛盾重重
彦	彦 彦士 彦涵
暮	暮 暮色 暮年 暮春 暮云 暮霭
聘	聘 聘请 聘用 聘礼 聘书 聘为
伪	伪 伪装 伪装成 伪君子 伪造 伪善
悍	悍 悍匪 悍马车 悍然 悍妇 悍将
韦	韦 韦小宝 韦小 韦斯利 韦德 韦斯特
瑰	瑰 瑰丽 瑰宝 瑰姿 瑰奇 瑰伟
瑜	瑜 瑜伽 瑜珈 瑜不掩瑕 瑜伽功 瑜珈术
晋	晋 晋级 晋升 晋阳 晋升为 晋南
呈	呈 呈现 呈现出 呈祥 呈几何 呈圆形
芊	芊 芊芊 芊绵
漱	漱 漱口 漱口水 漱洗 漱口杯 漱过
媒	媒 媒体 媒婆 媒人 媒介 媒妁之言
棵	棵 棵子 棵儿
翅	翅 翅膀 翅翼 翅子 翅儿 翅脉
翰	翰 翰墨 翰林 翰林院 翰海 翰林学士
屠	屠 屠杀 屠夫 屠龙 屠城 屠宰场
巅	巅 巅峰 巅峰状态 巅峰期
邱	邱 邱少云 邱先生 邱处机 邱吉尔 邱民仰
稚	稚 稚嫩 稚气 稚气未脱 稚童 稚子
泼	泼 泼妇 泼辣 泼出去 泼到 泼皮
娶	娶 娶媳妇 娶妻生子 娶妻 娶亲
溢	溢 溢出 溢于言表 溢满 溢血 溢美之词
辅	辅 辅助 辅导员 辅导 辅佐 辅导班
姗	姗 姗姗 姗姗来迟 姗笑 姗拉娜
璇	璇 璇玑 璇宫 璇霄丹阙
惫	惫 惫懒
斑	斑 斑驳 斑白 斑斓 斑斑 斑马线
饼	饼 饼干 饼子 饼铛 饼饵 饼屑
澈	澈 澈底 澈底澄清
叠	叠 叠好 叠加 叠成 叠放 叠起
塌	塌 塌陷 塌下来 塌方 塌下 塌鼻子
妒	妒 妒忌 妒火 妒嫉 妒火中烧 妒忌心
烫	烫 烫伤 烫手 烫金 烫得 烫发
纤	纤 纤细 纤纤 纤手 纤长 纤瘦
纤	纤 纤细 纤纤 纤手 纤长 纤瘦
蒂	蒂 蒂斯 蒂娜 蒂诺 蒂姆 蒂默
窃	窃 窃窃私语 窃喜 窃取 窃笑 窃听器
惩	惩 惩罚 惩戒 惩恶扬善 惩治 惩处
涉	涉 涉及 涉猎 涉嫌 涉足 涉世未深
炫	炫 炫耀 炫目 炫耀着 炫技 炫弄
祭	祭 祭坛 祭祀 祭奠 祭拜 祭品
虐	虐 虐待 虐杀 虐恋 虐待狂 虐待老人
辩	辩 辩解 辩论 辩驳 辩护 辩论赛
汐	汐 汐止
帐	帐 帐篷 帐号 帐户 帐目 帐房
叛	叛 叛逆 叛徒 叛变 叛军 叛乱
鸭	鸭 鸭子 鸭舌帽 鸭蛋 鸭梨 鸭舌
冻	冻 冻结 冻得 冻死 冻成 冻僵
腥	腥 腥味 腥臭 腥风血雨 腥红 腥臭味
躬	躬 躬身 躬身行礼 躬耕 躬行 躬亲
肺	肺 肺部 肺癌 肺腑 肺炎 肺活量
障	障 障碍 障碍物 障眼法 障壁 障礙
吁	吁 吁吁 吁气 吁请 吁叹 吁求
吁	吁 吁吁 吁气 吁请 吁叹 吁求
溃	溃 溃散 溃烂 溃败 溃不成军 溃逃
溃	溃 溃散 溃烂 溃败 溃不成军 溃逃
兼	兼 兼职 兼任 兼顾 兼修 兼备
澜	澜 澜沧江 澜沧 澜沧拉祜族自治县
靖	靖 靖宇 靖康 靖江 靖安 靖国神社
津	津 津津有味 津津乐道 津贴 津城 津市
拎	拎 拎包 拎下来 拎不清
耽	耽 耽误 耽搁 耽误时间 耽心 耽搁到
嗡	嗡 嗡嗡 嗡嗡作响 嗡嗡声 嗡嗡地 嗡嗡响
鉴	鉴 鉴定 鉴于 鉴赏 鉴别 鉴证
塑	塑 塑料袋 塑料 塑造 塑像 塑胶
锤	锤 锤子 锤炼 锤击 锤头 锤打
嘎	嘎 嘎嘎 嘎吱 嘎巴 嘎嘣脆 嘎啦
愕	愕 愕然 愕视
册	册 册子 册封 册页 册立 册亨
藤	藤 藤蔓 藤椅 藤条 藤原 藤甲
丐	丐 丐帮 丐幫
缕	缕 缕缕 缕述 缕陈 缕析
筹	筹 筹码 筹备 筹划 筹集 筹到
臣	臣 臣服 臣服于 臣妾 臣子 臣服在
狞	狞 狞笑 狞恶 狞髯张目 狞鬼
剪	剪 剪刀 剪辑 剪掉 剪子 剪短
嗨	嗨 嗨哟
伞	伞 伞兵 伞柄 伞状 伞盖 伞面
昆	昆 昆仑 昆虫 昆仑山 昆明 昆山
歇	歇 歇斯底里 歇息 歇歇 歇会儿 歇一会
蕾	蕾 蕾丝 蕾期
援	援 援助 援手 援军 援兵 援救
舔	舔 舔着 舔食 舔掉 舔吃 舔瓜子
储	储 储存 储备 储物柜 储藏室 储蓄
茂	茂 茂密 茂盛 茂林 茂德 茂名
裸	裸 裸露 裸奔 裸体 裸睡 裸女
赐	赐 赐予 赐给 赐福 赐教 赐死
讪	讪 讪讪 讪笑 讪讪地 讪谤 讪皮讪脸
狮	狮 狮子 狮吼 狮子头 狮子狗 狮子座
葬	葬 葬礼 葬送 葬身 葬仪 葬送在
宛	宛 宛如 宛若 宛然 宛西 宛城
磕	磕 磕头 磕磕绊绊 磕磕碰碰 磕磕巴巴 磕破
冤	冤 冤枉 冤家 冤魂 冤大头 冤家路窄
掀	掀 掀起 掀开 掀翻 掀到 掀掉
嫉	嫉 嫉妒 嫉恶如仇 嫉恨 嫉妒心 嫉妒者
蔓	蔓 蔓延 蔓延到 蔓藤 蔓儿 蔓草
惕	惕 惕厉 惕惧
蔓	蔓 蔓延 蔓延到 蔓藤 蔓儿 蔓草
奸	奸 奸笑 奸诈 奸商 奸计 奸情
喽	喽 喽啰 喽罗
肠	肠 肠子 肠胃 肠粉 肠道 肠胃炎
贯	贯 贯穿 贯彻 贯通 贯注 贯耳
叽	叽 叽叽喳喳 叽叽 叽里呱啦 叽里咕噜 叽叽咕咕
迁	迁 迁移 迁就 迁徙 迁怒 迁居
凄	凄 凄惨 凄凉 凄厉 凄美 凄苦
渡	渡 渡劫 渡过 渡船 渡口 渡江
卑	卑 卑微 卑鄙 卑躬屈膝 卑鄙无耻 卑劣
龟	龟 龟儿子 龟壳 龟裂 龟甲 龟缩
龟	龟 龟儿子 龟壳 龟裂 龟甲 龟缩
龟	龟 龟儿子 龟壳 龟裂 龟甲 龟缩
暑	暑 暑假 暑假作业 暑期 暑气 暑热
屎	屎 屎壳郎 屎尿 屎盆子 屎王 屎滚尿流
俺	俺 俺们 俺家 俺村 俺也来
犬	犬 犬吠 犬子 犬牙 犬齿 犬科
哆	哆 哆嗦 哆哆嗦嗦 哆里哆嗦
祈	祈 祈祷 祈求 祈福 祈雨 祈愿
框	框 框架 框框 框上 框子 框内
乏	乏 乏味 乏力 乏善可陈 乏力感 乏人问津
嘘	嘘 嘘寒问暖 嘘声 嘘声四起 嘘唏不已 嘘气
嘘	嘘 嘘寒问暖 嘘声 嘘声四起 嘘唏不已 嘘气
魁	魁 魁梧 魁首 魁星 魁元 魁伟
妄	妄 妄想 妄图 妄想症 妄动 妄为
崖	崖 崖壁 崖顶 崖柏 崖洞 崖谷
疏	疏 疏远 疏忽 疏散 疏通 疏离
凛	凛 凛冽 凛然 凛凛 凛然正气 凛厉
唔	唔 唔该晒
噩	噩 噩梦 噩耗 噩梦般 噩运 噩耗传来
狙	狙 狙击手 狙击枪 狙击 狙击步枪 狙杀
郊	郊 郊区 郊外 郊游 郊野 郊县
朦	朦 朦胧 朦朦胧胧 朦朦 朦胧诗 朦胧派
沸	沸 沸腾 沸沸扬扬 沸水 沸点 沸沸
滞	滞 滞留 滞后 滞涩 滞销 滞碍
鞭	鞭 鞭子 鞭炮 鞭炮声 鞭策 鞭打
粒	粒 粒子 粒粒 粒米 粒粒皆辛苦 粒细胞
蜂	蜂 蜂蜜 蜂拥 蜂拥而至 蜂巢 蜂拥而上
俯	俯 俯卧撑 俯视 俯身 俯瞰 俯下
撼	撼 撼动 撼天动地 撼天震地 撼人心魄 撼摇
瓦	瓦 瓦房 瓦片 瓦解 瓦砾 瓦特
夷	夷 夷为平地 夷陵 夷平 夷洲 夷族
胞	胞 胞弟 胞胎 胞兄 胞妹 胞姐
舟	舟 舟车劳顿 舟山 舟子 舟车 舟楫
鹿	鹿 鹿角 鹿鼎记 鹿死谁手 鹿肉 鹿城
桂	桂 桂花 桂花树 桂兰 桂林 桂平
轨	轨 轨迹 轨道 轨道舱 轨道车 轨道交通
革	革 革命 革新 革委会 革命战争 革职
革	革 革命 革新 革委会 革命战争 革职
耶	耶 耶稣 耶和华 耶鲁 耶路撒冷 耶鲁大学
颈	颈 颈部 颈椎 颈动脉 颈项 颈脖
颈	颈 颈部 颈椎 颈动脉 颈项 颈脖
勋	勋 勋章 勋爵 勋业 勋绩 勋伯格
嗤	嗤 嗤笑 嗤之以鼻
剂	剂 剂量 剂子 剂型 剂量计
瓷	瓷 瓷器 瓷砖 瓷碗 瓷瓶 瓷娃娃
坡	坡 坡度 坡顶 坡道 坡地 坡路
肢	肢 肢体 肢解 肢体冲突 肢残 肢离破碎
哮	哮 哮喘 哮喘病 哮鸣音
鞠	鞠 鞠躬 鞠一躬 鞠躬尽瘁 鞠躬礼 鞠养
芷	芷 芷江 芷江侗族自治县
甄	甄 甄别 甄选 甄志丙 甄子丹 甄宝玉
纱	纱 纱布 纱窗 纱裙 纱衣 纱巾
滩	滩 滩涂 滩头 滩地 滩海 滩头堡
狰	狰 狰狞 狰狞面目
炉	炉 炉子 炉火纯青 炉灶 炉火 炉灰
闫	闫 闫相闯 闫利军
秃	秃 秃顶 秃头 秃子 秃驴 秃鹫
煮	煮 煮饭 煮熟 煮沸 煮粥 煮茶
煌	煌 煌煌
罐	罐 罐子 罐头 罐装 罐车 罐中
扛	扛 扛着 扛起 扛不住 扛过 扛得住
扛	扛 扛着 扛起 扛不住 扛过 扛得住
寺	寺 寺庙 寺院 寺里 寺塔 寺山
壶	壶 壶里 壶盖 壶口 壶嘴 壶内
铮	铮 铮铮 铮亮 铮铮的 铮铮铁骨 铮铮铁汉
嬉	嬉 嬉笑 嬉皮笑脸 嬉戏 嬉闹 嬉笑怒骂
雇	雇 雇佣兵 雇主 雇佣 雇佣军 雇人
囊	囊 囊中羞涩 囊括 囊中 囊中之物 囊肿
拢	拢 拢共 拢络 拢子 拢岸 拢总
奢	奢 奢侈 奢华 奢望 奢侈品 奢求
弓	弓 弓箭 弓着腰 弓箭手 弓起 弓步
勺	勺 勺子 勺儿 勺园
绷	绷 绷带 绷紧 绷着 绷着脸 绷直
钉	钉 钉子 钉子户 钉死 钉耙 钉住
侦	侦 侦探 侦查 侦察 侦破 侦察兵
绽	绽 绽放 绽开 绽出 绽裂 绽破
壳	壳 壳子 壳里 壳儿 壳体 壳顶
昌	昌 昌盛 昌明 昌平 昌吉 昌河
壳	壳 壳子 壳里 壳儿 壳体 壳顶
枕	枕 枕头 枕边 枕着 枕巾 枕上
勃	勃 勃然大怒 勃发 勃勃生机 勃勃的 勃朗宁
樊	樊 樊城 樊笼 樊梨花 樊篱 樊南
衍	衍 衍生 衍化 衍生品 衍生物 衍变
庙	庙 庙里 庙宇 庙会 庙堂 庙前
琼	琼 琼斯 琼瑶 琼华 琼浆玉液 琼州
蛛	蛛 蛛丝马迹 蛛网 蛛丝 蛛蛛 蛛网状
逢	逢 逢年过节 逢凶化吉 逢场作戏 逢迎 逢集
淘	淘 淘汰 淘宝 淘气 淘宝网 淘金
搏	搏 搏斗 搏击 搏杀 搏动 搏战
诊	诊 诊所 诊断 诊室 诊治 诊金
汹	汹 汹涌 汹涌澎湃 汹汹
瘫	瘫 瘫坐 瘫痪 瘫软 瘫子 瘫痪病人
巡	巡 巡逻 巡视 巡查 巡警 巡航
嗽	嗽 嗽叭声 嗽口 嗽血
菊	菊 菊花 菊花茶 菊花瓣 菊展 菊花香
宵	宵 宵夜 宵小 宵禁 宵衣旰食 宵旰
捅	捅 捅破 捅进 捅出 捅穿 捅娄子
噜	噜 噜苏 噜嗦 噜囌
碑	碑 碑文 碑志 碑林 碑刻 碑碣
牲	牲 牲口 牲畜 牲口棚 牲礼
戈	戈 戈壁 戈壁滩 戈尔 戈矛 戈多
卜	卜 卜卦 卜算 卜筮 卜一卦 卜算子
宰	宰 宰割 宰相 宰杀 宰人 宰客
喧	喧 喧闹 喧嚣 喧哗 喧闹声 喧哗声
攀	攀 攀爬 攀谈 攀比 攀升 攀登
棺	棺 棺材 棺木 棺椁 棺盖 棺材板
沁	沁 沁人心脾 沁入 沁园春 沁水 沁人肺腑
寓	寓 寓意 寓言 寓所 寓于 寓教于乐
仆	仆 仆人 仆从 仆役 仆仆风尘 仆倒
搓	搓 搓手 搓衣板 搓麻 搓揉 搓澡
俞	俞 俞岱岩 俞飞鸿 俞伯牙 俞莲舟 俞先生
俞	俞 俞岱岩 俞飞鸿 俞伯牙 俞莲舟 俞先生
崽	崽 崽子 崽儿
耿	耿 耿耿于怀 耿直 耿耿 耿介 耿耿长
邢	邢 邢台 邢先生 邢州 邢姑娘 邢大姐
诞	诞 诞生 诞辰 诞生地 诞生石 诞生记
粮	粮 粮食 粮票 粮草 粮仓 粮油
芬	芬 芬芳 芬达 芬香 芬兰 芬奇
喻	喻 喻为 喻示 喻于义 喻可欣 喻上猷
膛	膛 膛线
岗	岗 岗位 岗亭 岗哨 岗子 岗上
巍	巍 巍峨 巍巍 巍然 巍然屹立 巍然矗立
届	届 届时 届满 届满时 届期 届临
匹	匹 匹配 匹敌 匹夫 匹夫无罪 匹练
咆	咆 咆哮 咆哮声 咆哮起来 咆哮地 咆啸
衷	衷 衷心 衷肠 衷心希望 衷心感谢 衷心祝愿
凰	凰 凰凤
拇	拇 拇指 拇趾 拇印 拇战
晒	晒 晒太阳 晒干 晒黑 晒晒 晒成
磁	磁 磁性 磁场 磁带 磁铁 磁力
抿	抿 抿嘴 抿着 抿着嘴 抿嘴笑 抿着嘴笑
贩	贩 贩卖 贩子 贩毒 贩卖毒品 贩卖机
循	循 循环 循声 循序渐进 循规蹈矩 循循善诱
湘	湘 湘竹 湘西 湘南 湘江 湘北
扒	扒 扒拉 扒开 扒皮 扒手 扒出
扒	扒 扒拉 扒开 扒皮 扒手 扒出
隙	隙 隙间 隙缝 隙地 隙驹 隙間
旷	旷 旷课 旷野 旷工 旷世 旷日持久
擎	擎 擎天 擎天柱 擎着 擎天之柱 擎天架海
押	押 押金 押送 押解 押运 押注
栽	栽 栽倒 栽培 栽种 栽赃 栽进
堡	堡 堡垒 堡主 堡子 堡寨 堡垒作用
堡	堡 堡垒 堡主 堡子 堡寨 堡垒作用
削	削 削弱 削瘦 削铁如泥 削苹果 削减
捣	捣 捣乱 捣鼓 捣蛋 捣蛋鬼 捣蒜
丸	丸 丸子 丸药 丸剂 丸散膏丹 丸泥封关
篷	篷 篷布 篷子 篷车 篷马车 篷帐
嗷	嗷 嗷嗷 嗷嗷叫 嗷嗷待哺
尧	尧 尧舜 尧山 尧帝 尧舜禹 尧舜禹汤
垫	垫 垫底 垫子 垫着 垫背 垫付
畜	畜 畜生 畜牲 畜牧业 畜牧 畜类
畜	畜 畜生 畜牲 畜牧业 畜牧 畜类
怯	怯 怯怯 怯生生 怯懦 怯场 怯弱
骤	骤 骤然 骤变 骤降 骤起 骤雨
揭	揭 揭开 揭穿 揭晓 揭发 揭露
僻	僻 僻静 僻静处 僻远 僻壤 僻巷
奴	奴 奴隶 奴才 奴仆 奴家 奴役
鸦	鸦 鸦雀无声 鸦片 鸦片战争 鸦雀 鸦鹊无声
汁	汁 汁液 汁水 汁儿
蓄	蓄 蓄力 蓄势待发 蓄意 蓄谋已久 蓄势
傍	傍 傍晚 傍边 傍水 傍晚时候 傍黑
蔽	蔽 蔽日 蔽体 蔽天 蔽空 蔽身
鹅	鹅 鹅蛋脸 鹅卵石 鹅蛋 鹅毛大雪 鹅黄色
僧	僧 僧人 僧袍 僧衣 僧侣 僧多粥少
蕴	蕴 蕴含 蕴含着 蕴藏 蕴涵 蕴育
蹬	蹬 蹬蹬 蹬腿 蹬车 蹬脚 蹬踏
憨	憨 憨厚 憨笑 憨憨的 憨子 憨厚老实
驴	驴 驴子 驴肝肺 驴打滚 驴车 驴肉
轿	轿 轿车 轿子 轿夫 轿厢 轿门
楞	楞 楞住 楞楞 楞了楞 楞楞地 楞伽
琢	琢 琢磨 琢磨不透 琢玉 琢成 琢玉成器
琢	琢 琢磨 琢磨不透 琢玉 琢成 琢玉成器
酱	酱 酱油 酱紫 酱汁 酱牛肉 酱料
沧	沧 沧桑 沧海 沧海桑田 沧桑感 沧州
虾	虾 虾米 虾子 虾兵蟹将 虾仁 虾肉
虾	虾 虾米 虾子 虾兵蟹将 虾仁 虾肉
蚂	蚂 蚂蚁 蚂蚱 蚂蟥 蚂蝗 蚂蚁窝
孕	孕 孕妇 孕育 孕育出 孕期 孕吐
怂	怂 怂恿
虞	虞 虞美人 虞城 虞舜 虞兮虞 虞者胜
览	览 览胜
茅	茅 茅山 茅屋 茅草屋 茅台 茅坑
侍	侍 侍卫 侍者 侍女 侍奉 侍从
弘	弘 弘扬 弘一 弘历 弘道 弘法
寡	寡 寡妇 寡人 寡不敌众 寡言少语 寡言
麒	麒 麒麟 麒麟山 麒麟座 麒麟盖
丘	丘 丘陵 丘比特 丘处机 丘陵地带 丘吉尔
廉	廉 廉价 廉洁 廉耻 廉租房 廉明
梭	梭 梭子 梭哈 梭鱼 梭罗 梭梭
梨	梨 梨花 梨花带雨 梨子 梨树 梨涡
薪	薪 薪水 薪资 薪酬 薪金 薪火
拧	拧 拧开 拧成 拧干 拧断 拧紧
骆	骆 骆驼 骆驼比 骆驼肉 骆宾王 骆驼峰
揪	揪 揪住 揪心 揪出来 揪出 揪起来
裕	裕 裕华 裕兴 裕禄 裕华区 裕如
骇	骇 骇人 骇然 骇人听闻 骇客 骇浪
昭	昭 昭示 昭君 昭雪 昭昭 昭阳
孽	孽 孽障 孽畜 孽种 孽子 孽债
翡	翡 翡翠 翡翠台 翡翠色 翡翠绿 翡冷翠
弦	弦 弦月 弦乐 弦外之音 弦音 弦歌
舰	舰 舰队 舰长 舰艇 舰船 舰载
狡	狡 狡黠 狡猾 狡辩 狡诈 狡兔
梧	梧 梧桐 梧桐树 梧桐叶 梧桐雨 梧桐山
溅	溅 溅出 溅射 溅落 溅得 溅湿
妃	妃 妃子 妃嫔 妃子笑 妃色 妃嫔媵嫱
综	综 综合 综艺节目 综艺 综合性 综合症
蓬	蓬 蓬松 蓬乱 蓬勃 蓬元帅 蓬头垢面
岭	岭 岭南 岭上 岭下 岭北 岭东
燥	燥 燥热 燥动 燥湿 燥音 燥风
债	债 债务 债主 债券 债有主 债台高筑
滔	滔 滔滔不绝 滔天 滔滔 滔天大罪 滔天罪行
鳞	鳞 鳞片 鳞次栉比 鳞甲 鳞伤 鳞鳞
咪	咪 咪咪 咪咪叫 咪康唑 咪唑类 咪表
棚	棚 棚子 棚户区 棚里 棚顶 棚内
灼	灼 灼热 灼烧 灼灼 灼伤 灼热感
祁	祁 祁阳 祁连 祁东 祁连山 祁山
唠	唠 唠叨 唠嗑 唠唠叨叨 唠扯
戳	戳 戳穿 戳破 戳戳 戳脊梁骨 戳伤
搅	搅 搅拌 搅动 搅和 搅乱 搅黄
苟	苟 苟延残喘 苟活 苟且 苟且偷生 苟同
荆	荆 荆棘 荆轲 荆山 荆州 荆条
帖	帖 帖子 帖服 帖近
醋	醋 醋意 醋溜 醋坛子 醋劲 醋瓶
诈	诈 诈骗 诈尸 诈骗犯 诈骗罪 诈唬
狄	狄 狄仁杰 狄更斯 狄安娜 狄云心 狄德罗
芯	芯 芯片 芯子 芯线 芯片级 芯片尺寸
庸	庸 庸俗 庸医 庸庸碌碌 庸人 庸人自扰
坟	坟 坟墓 坟地 坟头 坟场 坟堆
搁	搁 搁置 搁浅 搁着 搁下 搁笔
恳	恳 恳求 恳请 恳切 恳切地 恳谈
笛	笛 笛子 笛声 笛膜 笛音 笛卡尔
泳	泳 泳池 泳衣 泳装 泳裤 泳帽
愚	愚 愚蠢 愚人节 愚昧 愚钝 愚笨
驻	驻 驻足 驻扎 驻地 驻守 驻足观看
禹	禹 禹城 禹县 禹州 禹王台 禹门
擅	擅 擅长 擅自 擅闯 擅自行动 擅于
喳	喳 喳喳
喳	喳 喳喳
囔	囔 囔囔 囔着
猩	猩 猩红 猩猩 猩红色 猩红热 猩紅
昧	昧 昧着良心 昧良心 昧心 昧爽 昧於事理
厮	厮 厮杀 厮混 厮打 厮守 厮缠
拘	拘 拘谨 拘束 拘留 拘留所 拘捕
侄	侄 侄子 侄女 侄儿 侄女儿 侄媳妇
劣	劣 劣质 劣势 劣迹 劣根性 劣等
粥	粥 粥饭 粥少僧多 粥样 粥粥无能
嗖	嗖 嗖嗖
邮	邮 邮件 邮箱 邮寄 邮票 邮局
兆	兆 兆头 兆赫 兆示 兆瓦 兆麟
泊	泊 泊车 泊位 泊来 泊秦淮 泊头
泊	泊 泊车 泊位 泊来 泊秦淮 泊头
蹈	蹈 蹈海 蹈火 蹈袭 蹈入 蹈人旧辙
辨	辨 辨别 辨认 辨识 辨认出 辨别方向
芝	芝 芝麻 芝加哥 芝麻开门 芝兰 芝士
膜	膜 膜拜 膜法 膜炎 膜状 膜片
寥	寥 寥寥 寥寥无几 寥寥可数 寥落 寥寥数语
倦	倦 倦意 倦容 倦怠 倦色 倦态
浆	浆 浆糊 浆果 浆洗 浆液 浆汁
谐	谐 谐音 谐波 谐星 谐调 谐语
芦	芦 芦苇 芦苇荡 芦荟 芦苇丛 芦根
棉	棉 棉花 棉袄 棉被 棉衣 棉布
焕	焕 焕发 焕然一新 焕然 焕彩 焕然如新
缚	缚 缚鸡之力 缚住 缚成 缚紧 缚起来
拂	拂 拂面 拂尘 拂去 拂动 拂袖而去
佐	佐 佐野 佐藤 佐料 佐证 佐佐木
弧	弧 弧度 弧线 弧形 弧光 弧面
陨	陨 陨石 陨落 陨星 陨铁 陨灭
嚓	嚓 嚓嚓
嚓	嚓 嚓嚓
渺	渺 渺小 渺茫 渺渺 渺无人烟 渺无音讯
瞟	瞟 瞟向 瞟一眼 瞟见
茗	茗 茗茶
蒸	蒸 蒸发 蒸笼 蒸汽 蒸腾 蒸蒸日上
黯	黯 黯然 黯淡 黯然失色 黯然神伤 黯淡无光
蔑	蔑 蔑视 蔑称 蔑杀 蔑儿乞 蔑弃
渔	渔 渔船 渔民 渔网 渔场 渔村
督	督 督促 督察 督脉 督查 督军
衅	衅 衅端 衅发萧墙 衅隙
敞	敞 敞开 敞篷 敞亮 敞着 敞篷车
飙	飙 飙车 飙升 飙车族 飙举电至
茬	茬 茬子 茬口
掠	掠 掠过 掠夺 掠去 掠影 掠夺者
酬	酬 酬劳 酬金 酬谢 酬宾 酬神
嗅	嗅 嗅到 嗅觉 嗅出 嗅闻 嗅神经
厘	厘 厘米 厘清 厘金 厘定 厘订
烛	烛 烛光 烛火 烛台 烛龙 烛影
啃	啃 啃着 啃食 啃老族 啃得 啃噬
煎	煎 煎熬 煎饼 煎饼果子 煎蛋 煎药
粘	粘 粘着 粘稠 粘贴 粘液 粘住
粘	粘 粘着 粘稠 粘贴 粘液 粘住
忐	忐 忐忑 忐忑不安 忐忑不定
渗	渗 渗出 渗透 渗入 渗透到 渗进
唧	唧 唧唧 唧唧喳喳 唧唧咕咕 唧咕 唧唧嘎嘎
蝴	蝴 蝴蝶 蝴蝶结 蝴蝶效应 蝴蝶犬 蝴蝶梦
呛	呛 呛得 呛到 呛着 呛鼻 呛水
捞	捞 捞起 捞鱼 捞出 捞着 捞钱
殴	殴 殴打 殴斗 殴击 殴伤 殴辱
携	携 携带 携手 携带者 携程 携款
哨	哨 哨声 哨兵 哨子 哨响 哨音
梳	梳 梳着 梳理 梳洗 梳妆台 梳子
罕	罕 罕见 罕有 罕事 罕闻 罕見
淫	淫 淫笑 淫威 淫邪 淫贼 淫秽
橙	橙 橙子 橙色 橙汁 橙黄色 橙黄
唬	唬 唬住 唬人 唬得 唬吓
唬	唬 唬住 唬人 唬得 唬吓
阮	阮 阮士中 阮小七 阮玲玉 阮二人 阮师兄
舱	舱 舱门 舱内 舱室 舱体 舱口
蚊	蚊 蚊子 蚊虫 蚊帐 蚊香 蚊蝇
漓	漓 漓江 漓水
葱	葱 葱花 葱葱 葱郁 葱白 葱茏
枉	枉 枉费 枉死 枉然 枉自 枉法
蛊	蛊 蛊惑 蛊毒 蛊惑人心
塘	塘 塘边 塘村 塘沽 塘坝 塘塞
箫	箫 箫声 箫管 箫笙 箫韶九成
焉	焉 焉知非福 焉知 焉能 焉得虎子 焉耆
嚼	嚼 嚼舌根 嚼舌头 嚼蜡 嚼舌 嚼子
骷	骷 骷髅 骷髅头 骷髅兵 骷髅旗 骷髏
搐	搐 搐动 搐搦 搐缩
儒	儒 儒雅 儒家 儒生 儒学 儒道
瘾	瘾 瘾君子 瘾头
呕	呕 呕吐 呕吐物 呕心沥血 呕出 呕血
跺	跺 跺脚 跺跺脚 跺步
倚	倚 倚靠在 倚天 倚靠 倚靠着 倚老卖老
胶	胶 胶带 胶囊 胶水 胶布 胶鞋
揣	揣 揣着 揣测 揣摩 揣度 揣想
栗	栗 栗子 栗色 栗树 栗鼠 栗然
杉	杉 杉木 杉树 杉杉 杉树林 杉林
仲	仲 仲夏 仲裁 仲尼 仲裁者 仲春
妨	妨 妨碍 妨害 妨碍交通 妨礙 妨家
茉	茉 茉莉 茉莉花 茉莉花茶 茉茉
钓	钓 钓鱼 钓到 钓上来 钓竿 钓上
唾	唾 唾沫 唾液 唾弃 唾沫星子 唾手可得
衰	衰 衰老 衰竭 衰落 衰败 衰弱
衰	衰 衰老 衰竭 衰落 衰败 衰弱
缸	缸 缸子 缸盖 缸瓦 缸内 缸外
靓	靓 靓丽 靓女 靓妹 靓仔 靓姐
靓	靓 靓丽 靓女 靓妹 靓仔 靓姐
凸	凸 凸起 凸显 凸出 凸显出 凸出来
倪	倪 倪匡 倪云林 倪焕之 倪元璐 倪志钦
爵	爵 爵士 爵位 爵士乐 爵爷 爵士舞
翁	翁 翁美玲 翁婿 翁先生 翁源 翁波意
茵	茵 茵茵 茵陈 茵陈蒿 茵褥
遵	遵 遵守 遵循 遵命 遵从 遵纪守法
牺	牺 牺牲 牺牲品 牺牲者 牺牲生命 牺盟
嗒	嗒 嗒然若丧
嗒	嗒 嗒然若丧
逊	逊 逊色 逊于 逊尼派 逊位 逊谢
斧	斧 斧头 斧子 斧头帮 斧劈 斧凿
淌	淌 淌出 淌水 淌汗 淌泪 淌口水
喇	喇 喇叭 喇叭声 喇嘛 喇叭裤 喇叭花
姻	姻 姻缘 姻亲 姻伯 姻兄 姻戚
蝎	蝎 蝎子 蝎虎 蝎子王 蝎毒 蝎子草
扳	扳 扳机 扳指 扳手 扳回 扳倒
竭	竭 竭力 竭尽全力 竭尽所能 竭尽 竭诚
摧	摧 摧毁 摧残 摧枯拉朽 摧垮 摧花
蜘	蜘 蜘蛛 蜘蛛网 蜘蛛侠 蜘蛛精 蜘蛛丝
梵	梵 梵天 梵音 梵蒂冈 梵文 梵高
峻	峻 峻岭 峻峭 峻拔 峻工 峻厉
稻	稻 稻草 稻田 稻子 稻谷 稻草人
胀	胀 胀痛 胀大 胀鼓鼓 胀气 胀满
敛	敛 敛财 敛容 敛声屏气 敛聚 敛步
禽	禽 禽兽 禽兽不如 禽流感 禽鸟 禽类
逻	逻 逻辑 逻辑思维 逻辑性 逻辑推理 逻辑学
陡	陡 陡然 陡峭 陡然间 陡坡 陡崖
滨	滨 滨海 滨江 滨江路 滨州 滨河
攒	攒 攒钱 攒动 攒着 攒射 攒聚
攒	攒 攒钱 攒动 攒着 攒射 攒聚
淳	淳 淳朴 淳于 淳厚 淳安 淳熙
焚	焚 焚烧 焚身 焚香 焚毁 焚书坑儒
拱	拱 拱手 拱门 拱桥 拱形 拱起
熏	熏 熏陶 熏得 熏香 熏肉 熏天
窍	窍 窍门 窍取
绯	绯 绯红 绯闻 绯色 绯红色
翩	翩 翩翩 翩翩起舞 翩然 翩翩公子 翩跹
茄	茄 茄子 茄汁 茄克 茄鲞 茄克衫
茄	茄 茄子 茄汁 茄克 茄鲞 茄克衫
熄	熄 熄灭 熄灯 熄火 熄掉 熄灯号
湾	湾 湾里 湾子 湾流 湾仔 湾区
浇	浇 浇水 浇灌 浇灭 浇筑 浇花
雁	雁 雁门关 雁城 雁过拔毛 雁北 雁门
贡	贡 贡献 贡品 贡献度 贡献力量 贡茶
拯	拯 拯救 拯民 拯救队
擒	擒 擒拿 擒住 擒贼先擒王 擒拿格斗 擒获
喔	喔 喔喔叫
喔	喔 喔喔叫
兀	兀 兀自 兀然 兀立 兀鹰 兀突
剥	剥 剥夺 剥离 剥开 剥削 剥落
痞	痞 痞子 痞里痞气 痞子男 痞满 痞棍
绰	绰 绰号 绰绰有余 绰约 绰约多姿 绰绰有裕
卸	卸 卸下 卸载 卸掉 卸下来 卸去
狭	狭 狭小 狭窄 狭长的 狭长 狭隘
钧	钧 钧道 钧窑 钧瓷 钧天广乐 钧谕
睹	睹 睹物思人 睹物思情 睹物伤情 睹景伤情
钞	钞 钞票 钞本 钞录
杖	杖 杖刑
逮	逮 逮到 逮住 逮捕 逮捕令 逮捕证
敷	敷 敷衍 敷衍了事 敷上 敷着 敷药
吭	吭 吭声 吭哧 吭气
吭	吭 吭声 吭哧 吭气
笙	笙 笙歌 笙箫 笙簧 笙磬同音
瀚	瀚 瀚海
祷	祷 祷告 祷文 祷词 祷告词 祷念
蔬	蔬 蔬菜 蔬菜水果 蔬菜种子 蔬果 蔬菜基地
贸	贸 贸然 贸易 贸贸然 贸易中心 贸易往来
顽	顽 顽皮 顽强 顽固 顽劣 顽童
奎	奎 奎特 奎斯 奎因 奎尔 奎屯
翎	翎 翎儿 翎子 翎毛 翎翅
哧	哧 哧溜 哧哧
弊	弊 弊端 弊病 弊大于利 弊政 弊衣箪食
揽	揽 揽住 揽入 揽胜 揽客 揽活
咸	咸 咸菜 咸鱼 咸猪 咸阳 咸鱼翻身
棱	棱 棱角分明 棱角 棱形 棱儿 棱柱
恬	恬 恬静 恬不知耻 恬淡 恬然 恬美
帕	帕 帕萨特 帕子 帕特里斯 帕特 帕金斯
琉	琉 琉璃 琉璃瓦 琉璃厂 琉球 琉璃灯
拭	拭 拭去 拭目以待 拭干 拭泪 拭净
穹	穹 穹顶 穹苍 穹窿 穹隆 穹宇
裴	裴 裴元绍 裴多菲 裴勇俊 裴松之 裴将军
蟒	蟒 蟒蛇 蟒袍 蟒山 蟒袍玉带
饥	饥 饥饿 饥饿感 饥渴 饥肠辘辘 饥不择食
绘	绘 绘画 绘制 绘声绘色 绘图 绘成
钩	钩 钩子 钩钩 钩住 钩心斗角 钩起
婕	婕 婕妤
犀	犀 犀利 犀牛 犀角 犀牛皮 犀牛望月
珂	珂 珂罗版
昔	昔 昔日 昔年 昔时 昔者 昔人
潭	潭 潭水 潭边 潭底 潭里 潭州
凹	凹 凹凸 凹陷 凹槽 凹凸不平 凹痕
擂	擂 擂台 擂鼓 擂主 擂台赛 擂肥
侮	侮 侮辱 侮辱性 侮骂 侮蔑 侮辱罪
扁	扁 扁担 扁平 扁扁的 扁鹊 扁舟
扁	扁 扁担 扁平 扁扁的 扁鹊 扁舟
岔	岔 岔开 岔路 岔子 岔气 岔道
馒	馒 馒头 馒头山 馒首
涕	涕 涕泪 涕零 涕泗横流 涕泣 涕泗滂沱
絮	絮 絮絮叨叨 絮叨 絮语 絮絮 絮状
惶	惶 惶恐 惶恐不安 惶惶 惶急 惶惶不安
贞	贞 贞操 贞元 贞洁 贞观 贞淑
芙	芙 芙蓉 芙蓉王 芙蓉姐姐 芙蓉花 芙琳
沃	沃 沃尔玛 沃土 沃伦 沃尔沃 沃洲
趋	趋 趋势 趋于 趋之若鹜 趋向 趋炎附势
懦	懦 懦弱 懦夫 懦怯
腮	腮 腮帮子 腮帮 腮红 腮腺炎 腮颊
埃	埃 埃及 埃菲尔铁塔 埃克斯 埃塔 埃文
株	株 株式会社 株洲 株型 株连九族 株连
贷	贷 贷款 贷出 贷给 贷个 贷款额度
煤	煤 煤矿 煤炭 煤气 煤油灯 煤球
葫	葫 葫芦 葫芦娃 葫芦丝 葫芦藤 葫芦兄弟
杭	杭 杭州 杭城 杭州大学 杭州人 杭州市
盐	盐 盐水 盐城 盐巴 盐汽水 盐分
履	履 履行 履历 履带 履历表 履行诺言
禅	禅 禅房 禅院 禅师 禅宗 禅定
禅	禅 禅房 禅院 禅师 禅宗 禅定
寨	寨 寨子 寨主 寨里 寨门 寨外
毙	毙 毙命 毙掉 毙伤
搀	搀 搀扶 搀扶着 搀和 搀起 搀住
肘	肘 肘子 肘部 肘关节 肘弯 肘尖
袜	袜 袜子 袜业 袜带 袜套 袜筒
淹	淹 淹没 淹死 淹到 淹埋 淹城
甫	甫 甫士 甫志高 甫琴
恤	恤 恤衫 恤孤 恤民 恤金 恤老怜贫
陋	陋 陋习 陋室 陋室铭 陋巷 陋俗
叭	叭 叭叭 叭儿狗 叭嗒
佟	佟 佟佳氏 佟湘玉 佟麟阁 佟军门 佟国纲
掰	掰 掰开 掰断 掰掰 掰腕子
瘪	瘪 瘪三 瘪嘴 瘪瘪的 瘪着嘴 瘪三儿
蝇	蝇 蝇头 蝇头小利 蝇营狗苟 蝇头小楷 蝇子
砂	砂 砂锅 砂石 砂砾 砂糖 砂纸
廷	廷 廷尉 廷长 廷杖 廷试 廷布
琅	琅 琅琅 琅嬛福地 琅琊山 琅琅上口 琅琅的
译	译 译文 译名 译成 译作 译音
髓	髓 髓海 髓质 髓石 髓心 髓室
碟	碟 碟片 碟子 碟机 碟形 碟中谍
嗔	嗔 嗔怪 嗔怒 嗔怨 嗔戒 嗔责
艘	艘 艘次
倔	倔 倔强 倔强地 倔犟 倔劲 倔头倔脑
踉	踉 踉跄 踉踉跄跄 踉踉 踉蹌
晌	晌 晌午
涡	涡 涡轮 涡流 涡旋 涡扇 涡桨
涡	涡 涡轮 涡流 涡旋 涡扇 涡桨
脯	脯 脯氨酸
脯	脯 脯氨酸
屉	屉 屉子
窥	窥 窥视 窥探 窥见 窥伺 窥破
绊	绊 绊倒 绊子 绊脚石 绊住 绊脚
辫	辫 辫子 辫儿
撩	撩 撩起 撩人 撩拨 撩开 撩动
桀	桀 桀桀 桀骜不驯 桀骜 桀骜不逊 桀骜难驯
叙	叙 叙述 叙旧 叙叙旧 叙说 叙事
拓	拓 拓展 拓宽 拓跋 拓印 拓荒
蜀	蜀 蜀山 蜀黍 蜀都 蜀国 蜀地
詹	詹 詹姆斯 詹姆士 詹森 詹家 詹姆斯敦
菩	菩 菩萨 菩提 菩提树 菩提子 菩萨心肠
逞	逞 逞强 逞能 逞英雄 逞一时之 逞威风
澄	澄 澄清 澄澈 澄光 澄明 澄海
澄	澄 澄清 澄澈 澄光 澄明 澄海
堕	堕 堕落 堕入 堕胎 堕落街 堕胎药
坎	坎 坎坷 坎儿 坎肩 坎坎坷坷 坎坷不平
蚀	蚀 蚀刻 蚀本 蚀损 蚀成
疙	疙 疙瘩 疙疙瘩瘩 疙瘩汤 疙里疙瘩 疙疸
晖	晖 晖映
悸	悸 悸动 悸動
酿	酿 酿成 酿造 酿酒 酿制 酿酒师
妩	妩 妩媚 妩媚动人 妩媚多姿
芽	芽 芽儿 芽苞 芽尖 芽庄 芽接
盔	盔 盔甲 盔帽 盔胄 盔子
椒	椒 椒盐 椒料 椒江 椒江区
盲	盲 盲目 盲人 盲区 盲流 盲点
骏	骏 骏马 骏业 骏马奔驰 骏骨 骏发
嘈	嘈 嘈杂 嘈杂声 嘈嘈杂杂 嘈嘈切切 嘈嚷
绅	绅 绅士 绅士风度 绅士派 绅商 绅宦
乍	乍 乍一看 乍现 乍然 乍一听 乍看
役	役 役使 役所 役畜 役龄 役男
撸	撸 撸子
沦	沦 沦落 沦为 沦陷 沦丧 沦落人
涟	涟 涟漪 涟涟 涟水 涟波 涟源
铠	铠 铠甲 铠装
垮	垮 垮掉 垮塌 垮台 垮下来 垮下
勿	勿 勿扰 勿近 勿忘 勿进 勿念
赴	赴 赴约 赴汤蹈火 赴宴 赴死 赴美
乳	乳 乳白色 乳臭未干 乳名 乳白 乳房
捆	捆 捆绑 捆住 捆着 捆起来 捆好
蜡	蜡 蜡烛 蜡黄 蜡笔小新 蜡像 蜡笔
娥	娥 娥眉 娥眉月
蜡	蜡 蜡烛 蜡黄 蜡笔小新 蜡像 蜡笔
眩	眩 眩晕 眩目 眩光 眩惑 眩人
蔚	蔚 蔚蓝 蔚蓝色 蔚然 蔚为壮观 蔚然成风
蔚	蔚 蔚蓝 蔚蓝色 蔚然 蔚为壮观 蔚然成风
豁	豁 豁出去 豁然开朗 豁然 豁达 豁口
乙	乙 乙方 乙肝 乙级 乙班 乙丙
暧	暧 暧昧 暧昧关系 暧昧不明 暧昧之情 暧昧行为
娴	娴 娴熟 娴静 娴雅 娴淑 娴于辞令
盏	盏 盏灯
颅	颅 颅内 颅骨 颅腔 颅脑 颅底
伺	伺 伺候 伺机 伺机而动 伺机报复 伺弄
伺	伺 伺候 伺机 伺机而动 伺机报复 伺弄
龚	龚 龚光杰 龚自珍 龚先生 龚定庵 龚古尔
弗	弗 弗兰克 弗拉德 弗利 弗洛伊德 弗朗西斯
黝	黝 黝黑 黝暗
莽	莽 莽撞 莽汉 莽夫 莽莽 莽莽撞撞
崎	崎 崎岖 崎岖不平 崎岖难走 崎婆 崎嶇
颓	颓 颓废 颓然 颓丧 颓唐 颓势
暇	暇 暇接 暇时 暇日
兢	兢 兢兢业业 兢兢战战 兢兢業業
绒	绒 绒毛 绒布 绒球 绒绒的 绒毯
漩	漩 漩涡 漩流 漩起 漩风
肋	肋 肋骨 肋间 肋条 肋巴骨 肋软骨
肝	肝 肝脏 肝癌 肝肠寸断 肝胆 肝胆相照
遁	遁 遁入 遁走 遁形 遁入空门 遁逃
戮	戮 戮破 戮力 戮力同心 戮力一心
骁	骁 骁勇 骁勇善战 骁将 骁骑 骁悍
荫	荫 荫凉 荫庇 荫蔽 荫影 荫翳
渠	渠 渠道 渠水 渠口 渠沟 渠道商
嗜	嗜 嗜血 嗜好 嗜睡 嗜酒 嗜酒如命
懊	懊 懊恼 懊悔 懊恼不已 懊悔不已 懊丧
毯	毯 毯子
剔	剔 剔除 剔透 剔着 剔骨 剔牙
酥	酥 酥麻 酥软 酥胸 酥麻麻 酥酥的
炽	炽 炽热 炽烈 炽天使 炽盛 炽燃
践	践 践踏 践行 践踏着 践踏在 践墨随敌
杠	杠 杠杠 杠杆 杠铃 杠子 杠杆原理
浊	浊 浊气 浊酒 浊世 浊水 浊者自浊
窄	窄 窄小 窄窄的 窄道 窄巷 窄窄
钮	钮 钮祜禄 钮扣 钮永建 钮茂生 钮先钟
桩	桩 桩子 桩头 桩脚 桩木 桩冠
赠	赠 赠送 赠与 赠予 赠送给 赠品
诛	诛 诛杀 诛灭 诛戮 诛除 诛心之论
哽	哽 哽咽 哽住 哽噎 哽在 哽哽咽咽
坪	坪 坪上 坪地 坪寨 坪坝 坪上村
枭	枭 枭雄 枭首 枭将 枭蛇鬼怪 枭首示众
蒲	蒲 蒲团 蒲扇 蒲公英 蒲草 蒲松龄
攘	攘 攘攘 攘外必先安内 攘夷 攘臂 攘攘熙熙
艇	艇 艇长 艇员
朔	朔 朔风 朔州 朔月 朔方 朔望
悚	悚 悚然 悚惧
铐	铐 铐起来
绣	绣 绣花 绣花针 绣球 绣花枕头 绣花鞋
汰	汰 汰去 汰衣裳 汰劣 汰菜 汰旧换新
诅	诅 诅咒 诅骂 诅咒语
匀	匀 匀称 匀速 匀匀 匀出 匀净
惺	惺 惺忪 惺惺相惜 惺惺 惺惺作态 惺松
溺	溺 溺爱 溺水 溺死 溺水者 溺毙
螺	螺 螺旋 螺丝 螺丝刀 螺旋桨 螺纹
瘸	瘸 瘸子 瘸腿 瘸脚
遣	遣 遣散 遣送 遣返 遣散费 遣词造句
祟	祟 祟高
瓣	瓣 瓣膜 瓣膜病
碾	碾 碾压 碾碎 碾过 碾子 碾成
杏	杏 杏子 杏眼 杏花 杏儿 杏树
棠	棠 棠棣 棠梨 棠湖
蟹	蟹 蟹黄 蟹肉 蟹壳 蟹粉 蟹爪
坊	坊 坊间 坊肆 坊地 坊子 坊本
蛤	蛤 蛤蟆 蛤蟆镜 蛤蜊 蛤蟆功 蛤蚧
蛤	蛤 蛤蟆 蛤蟆镜 蛤蜊 蛤蟆功 蛤蚧
刁	刁 刁难 刁蛮 刁钻 刁民 刁钻古怪
慑	慑 慑服
脂	脂 脂肪 脂粉 脂肪肝 脂粉气 脂肪酸
脊	脊 脊背 脊梁 脊椎 脊梁骨 脊柱
痹	痹 痹症 痹证
霎	霎 霎时 霎时间 霎那间 霎那 霎时之间
挫	挫 挫折 挫败 挫伤 挫骨扬灰 挫折感
偌	偌 偌大
漪	漪 漪澜 漪涟
霓	霓 霓虹灯 霓虹 霓裳 霓红灯
囚	囚 囚犯 囚禁 囚笼 囚车 囚徒
葡	葡 葡萄 葡萄酒 葡萄糖 葡萄架 葡萄藤
湛	湛 湛蓝 湛卢 湛江 湛蓝湛蓝 湛山
窟	窟 窟窿 窟窿眼 窟窿眼儿 窟宅 窟穴
掘	掘 掘墓 掘进 掘金 掘开 掘起
褚	褚 褚万里 褚时健 褚兄弟 褚遂良 褚慎明
褚	褚 褚万里 褚时健 褚兄弟 褚遂良 褚慎明
仑	仑 仑背
辟	辟 辟邪 辟谷 辟谣 辟开 辟作
辟	辟 辟邪 辟谷 辟谣 辟开 辟作
蝉	蝉 蝉鸣 蝉儿 蝉翼 蝉联 蝉声
黛	黛 黛安娜 黛绿 黛蛾
陀	陀 陀螺 陀罗尼 陀罗 陀枪师姐 陀螺仪
棘	棘 棘手 棘突 棘刺 棘轮 棘皮
窒	窒 窒息 窒息而死 窒闷 窒塞 窒碍
饺	饺 饺子 饺子馆 饺子馅 饺子皮 饺子宴
蔼	蔼 蔼蔼 蔼然 蔼然可亲 蔼然仁者
悻	悻 悻悻 悻悻然 悻然
矫	矫 矫情 矫健 矫正 矫捷 矫揉造作
癫	癫 癫狂 癫痫 癫痫病 癫疯 癫子
睫	睫 睫毛 睫毛膏 睫毛夹 睫毛刷 睫状肌
徘	徘 徘徊 徘徊者 徘徊不前 徘徊歧路
惬	惬 惬意 惬当 惬心贵当 惬怀
谣	谣 谣言 谣传 谣言止于 谣言满天 谣谚
浏	浏 浏览 浏览器 浏阳 浏览者 浏览量
栩	栩 栩栩如生 栩栩 栩栩然 栩栩欲活
咏	咏 咏春拳 咏春 咏唱 咏梅 咏叹
檀	檀 檀木 檀香 檀香木 檀香山 檀香扇
馈	馈 馈赠 馈线 馈电 馈送 馈遗
谑	谑 谑浪笑敖 谑而不虐 谑浪笑傲
膏	膏 膏药 膏药旗 膏状 膏肓 膏盲
夭	夭 夭折 夭寿 夭亡 夭矫 夭逝
轴	轴 轴承 轴心 轴距 轴线 轴承厂
蝠	蝠 蝠王
薯	薯 薯片 薯条 薯类 薯藤 薯條
桦	桦 桦林 桦树 桦木 桦川 桦树皮
沮	沮 沮丧 沮洳 沮喪
纲	纲 纲要 纲领 纲常 纲目 纲纪
亢	亢 亢奋 亢龙有悔 亢进 亢金龙 亢盛
萎	萎 萎靡 萎缩 萎靡不振 萎顿 萎蔫
疫	疫 疫苗 疫情 疫病 疫区 疫疠
蜷	蜷 蜷缩 蜷曲 蜷伏 蜷局 蜷縮
炯	炯 炯炯有神 炯炯 炯然
巢	巢 巢穴 巢里 巢湖 巢中 巢内
尉	尉 尉迟 尉迟恭 尉官 尉缭 尉迟敬德
尉	尉 尉迟 尉迟恭 尉官 尉缭 尉迟敬德
苑	苑 苑里 苑仙葩 苑琼丹 苑家屯 苑囿
霏	霏 霏霏 霏霏细雨
侈	侈 侈靡 侈谈 侈言 侈侈不休
朽	朽 朽木 朽木不可雕 朽烂 朽坏 朽木不雕
亩	亩 亩产 亩产量 亩数 亩产值
氧	氧 氧气 氧化 氧气瓶 氧气管 氧吧
菱	菱 菱形 菱角 菱镜 菱花 菱锰矿
禾	禾 禾苗 禾田 禾场 禾草 禾稻
聋	聋 聋子 聋哑人 聋哑学校 聋哑 聋人
啼	啼 啼哭 啼笑皆非 啼叫 啼声 啼鸣
捶	捶 捶打 捶背 捶胸顿足 捶腿 捶胸
讥	讥 讥讽 讥笑 讥诮 讥笑声 讥嘲
蹙	蹙 蹙眉 蹙额
眷	眷 眷顾 眷恋 眷念 眷属 眷恋着
懈	懈 懈怠 懈惰 懈慢 懈弛 懈气
炙	炙 炙热 炙烤 炙手可热 炙手可得 炙熱
捋	捋 捋起 捋胳膊 捋虎须 捋袖揎拳
崛	崛 崛起 崛地而起
蹄	蹄 蹄子 蹄印 蹄声 蹄膀 蹄筋
惭	惭 惭愧 惭色
喋	喋 喋喋不休 喋血 喋喋 喋血记
喋	喋 喋喋不休 喋血 喋喋 喋血记
噼	噼 噼里啪啦 噼啪 噼噼啪啪 噼噼叭叭
漾	漾 漾濞
癌	癌 癌症 癌细胞 癌变 癌症病人 癌基因
俄	俄 俄罗斯 俄语 俄国 俄文 俄国人
捐	捐 捐款 捐赠 捐给 捐献 捐助
镶	镶 镶嵌 镶着 镶边 镶满 镶金
敖	敖 敖广 敖包 敖德萨 敖秀才 敖顺
绞	绞 绞尽脑汁 绞痛 绞杀 绞碎 绞肉机
猿	猿 猿猴 猿人 猿类 猿臂 猿啼
镰	镰 镰刀 镰刀状 镰刀形 镰状
鲨	鲨 鲨鱼 鲨鱼肉 鲨烯
憬	憬 憬悟 憬然有悟
怠	怠 怠慢 怠惰 怠倦 怠工 怠情
憔	憔 憔悴
兹	兹 兹曼 兹将 兹事体大 兹罗提
兹	兹 兹曼 兹将 兹事体大 兹罗提
纽	纽 纽约 纽扣 纽带 纽约市 纽约大学
函	函 函数 函授 函谷关 函授班 函授大学
犊	犊 犊子 犊鼻 犊牛 犊车
晦	晦 晦气 晦涩 晦暗 晦明 晦朔
悯	悯 悯惜
铲	铲 铲子 铲除 铲车 铲平 铲起
惋	惋 惋惜 惋叹 惋伤
泠	泠 泠然
馅	馅 馅饼 馅儿 馅儿饼 馅料 馅心
挚	挚 挚友 挚爱 挚交 挚诚 挚情
熠	熠 熠熠生辉 熠熠 熠耀 熠熠闪闪 熠熠生輝
掺	掺 掺杂 掺和 掺合 掺假 掺入
谜	谜 谜团 谜底 谜题 谜一样 谜语
褪	褪 褪去 褪色 褪下 褪尽 褪掉
烙	烙 烙印 烙饼 烙铁 烙成 烙痕
缭	缭 缭绕 缭乱
棕	棕 棕色 棕熊 棕黄色 棕红色 棕榈树
税	税 税收 税务局 税务 税后 税费
肾	肾 肾虚 肾上腺素 肾亏 肾脏 肾上腺
臀	臀 臀部 臀围 臀鳍 臀尖
晏	晏 晏子 晏婴 晏驾 晏子春秋 晏平仲
柠	柠 柠檬 柠檬水 柠檬汁 柠檬茶 柠檬酸
菁	菁 菁菁 菁华 菁英 菁英份子
蓦	蓦 蓦然 蓦地 蓦然回首
檐	檐 檐下 檐角 檐口 檐前 檐瓦
铅	铅 铅笔 铅球 铅笔盒 铅块 铅华
铅	铅 铅笔 铅球 铅笔盒 铅块 铅华
铛	铛 铛铛
铛	铛 铛铛
罡	罡 罡风
炭	炭 炭火 炭炉 炭笔 炭黑 炭烧
裆	裆 裆部
褂	褂 褂子
蝙	蝙 蝙蝠 蝙蝠侠 蝙蝠衫 蝙蝠洞
稽	稽 稽首 稽查 稽查队 稽查人员 稽考
稽	稽 稽首 稽查 稽查队 稽查人员 稽考
葵	葵 葵花宝典 葵花 葵花籽 葵扇 葵叶
蹑	蹑 蹑手蹑脚 蹑着 蹑足 蹑着脚 蹑脚
滥	滥 滥用 滥竽充数 滥杀无辜 滥用职权 滥情
隶	隶 隶属于 隶属 隶书 隶字 隶农
澳	澳 澳门 澳洲 澳大利亚 澳大利亚人 澳元
撂	撂 撂倒 撂下 撂挑子 撂荒 撂下来
粪	粪 粪便 粪坑 粪土 粪池 粪堆
鲍	鲍 鲍鱼 鲍威尔 鲍罗廷 鲍老板 鲍里斯
浦	浦 浦东 浦江 浦西 浦和 浦东国际机场
刊	刊 刊登 刊物 刊载 刊发 刊出
锈	锈 锈迹斑斑 锈迹 锈蚀 锈了 锈铁
蛙	蛙 蛙跳 蛙鸣 蛙声 蛙叫 蛙泳
黏	黏 黏在 黏糊糊 黏着 黏住 黏上
憧	憧 憧憬 憧憬未来
遂	遂 遂即 遂愿 遂定 遂宁 遂心
徽	徽 徽章 徽州 徽商 徽标 徽宗
翟	翟 翟志刚 翟乃社 翟理斯 翟秋白
翟	翟 翟志刚 翟乃社 翟理斯 翟秋白
菇	菇 菇类
廓	廓 廓落 廓尔喀 廓清
秩	秩 秩序 秩序井然 秩和 秩边 秩序性
顷	顷 顷刻间 顷刻 顷刻之间 顷襄王 顷之
鸽	鸽 鸽子 鸽子笼 鸽群 鸽蛋 鸽哨
怅	怅 怅然若失 怅然 怅惘 怅怅 怅怅然
崭	崭 崭新 崭露头角 崭露 崭露头脚 崭新面貌
吆	吆 吆喝 吆喝声 吆五喝六 吆喊 吆呼
钦	钦 钦佩 钦点 钦定 钦慕 钦差
奄	奄 奄奄一息 奄奄 奄然 奄忽 奄奄待毙
慵	慵 慵懒 慵懶
觅	觅 觅食 觅得 觅路 觅取 觅句
竿	竿 竿子 竿头
噎	噎 噎着 噎住 噎到 噎噎 噎嗝
拌	拌 拌嘴 拌面 拌匀 拌蒜 拌点
殖	殖 殖民 殖民地 殖民者 殖民统治 殖民军
殖	殖 殖民 殖民地 殖民者 殖民统治 殖民军
幺	幺 幺幺小丑
诵	诵 诵读 诵经 诵经声 诵念 诵出
拙	拙 拙劣 拙作 拙笔 拙于 拙政园
抠	抠 抠门 抠出来 抠出 抠掉 抠破
汝	汝 汝矣岛 汝阳 汝辈 汝阳王 汝有何
瀑	瀑 瀑布 瀑布群 瀑流 瀑布区 瀑河
瀑	瀑 瀑布 瀑布群 瀑流 瀑布区 瀑河
亨	亨 亨利 亨特 亨通 亨德尔 亨得利
腊	腊 腊月 腊肉 腊梅 腊肠 腊八
腊	腊 腊月 腊肉 腊梅 腊肠 腊八
眈	眈 眈眈
甸	甸 甸子
歆	歆 歆羡 歆羨
咣	咣 咣当 咣噹
跆	跆 跆拳道 跆拳 跆拳道队
惦	惦 惦记 惦记着 惦念 惦着 惦念着
讳	讳 讳莫如深 讳疾忌医 讳忌 讳言 讳病忌医
迸	迸 迸发 迸发出 迸射 迸出 迸溅
锡	锡 锡安 锡林 锡纸 锡壶 锡伯族
沛	沛 沛县
署	署 署名 署长 署名权 署名文章 署理
衔	衔 衔接 衔尾 衔住 衔环 衔接起来
淇	淇 淇澳 淇县
婵	婵 婵娟
秉	秉 秉承 秉性 秉着 秉持着 秉持
匠	匠 匠人 匠师 匠心 匠心独运 匠气
羲	羲 羲皇上人
绮	绮 绮罗 绮丽 绮梦 绮思 绮想
恕	恕 恕罪 恕我直言 恕不奉陪 恕难从命 恕道
纨	纨 纨绔 纨绔子弟 纨扇 纨袴膏粱 纨袴子弟
嵌	嵌 嵌入 嵌进 嵌入式 嵌合 嵌金
嵌	嵌 嵌入 嵌进 嵌入式 嵌合 嵌金
糙	糙 糙米 糙米饭 糙纸 糙粮
靡	靡 靡靡之音 靡丽 靡不 靡费 靡不有初
弈	弈 弈棋 弈具
藉	藉 藉此 藉口 藉由 藉以 藉着
韧	韧 韧性 韧带 韧劲 韧度 韧劲儿
蛟	蛟 蛟龙 蛟河 蛟龙戏水 蛟河县 蛟龙得水
烽	烽 烽火 烽火台 烽烟 烽火连天 烽烟四起
鲤	鲤 鲤鱼 鲤鱼打挺 鲤跃龙门 鲤科 鲤城区
灶	灶 灶台 灶房 灶火 灶头 灶膛
峥	峥 峥嵘 峥嵘岁月 峥峥
渍	渍 渍水 渍染 渍涝
筐	筐 筐子 筐头子 筐笼
橘	橘 橘子 橘黄色 橘红色 橘色 橘黄
柿	柿 柿子 柿子树 柿饼 柿树 柿子椒
玖	玖 玖艘
匿	匿 匿名 匿名信 匿迹 匿名举报 匿藏
茧	茧 茧子 茧绸 茧丝 茧层
璨	璨 璨美
莺	莺 莺莺燕燕 莺燕 莺啼 莺歌燕舞 莺声燕语
癞	癞 癞蛤蟆 癞蛤蟆想吃天鹅肉 癞子 癞皮狗 癞头
瑕	瑕 瑕疵 瑕不掩瑜 瑕疵品 瑕瑜互见 瑕瑜
莞	莞 莞尔一笑 莞尔 莞爾 莞尔而笑
莞	莞 莞尔一笑 莞尔 莞爾 莞尔而笑
缉	缉 缉毒 缉拿 缉捕 缉拿归案 缉私
缉	缉 缉毒 缉拿 缉捕 缉拿归案 缉私
炖	炖 炖肉 炖鸡 炖汤 炖着 炖排骨
笃	笃 笃定 笃笃 笃信 笃行 笃学
歧	歧 歧视 歧义 歧途 歧路 歧山
厄	厄 厄运 厄尔尼诺 厄尔 厄难 厄瓜多尔
膨	膨 膨胀 膨胀起来 膨大 膨化食品 膨化
矜	矜 矜持 矜贵 矜夸 矜恤 矜重
矜	矜 矜持 矜贵 矜夸 矜恤 矜重
矜	矜 矜持 矜贵 矜夸 矜恤 矜重
驼	驼 驼背 驼子 驼着背 驼铃 驼队
幢	幢 幢幢
燎	燎 燎原 燎原之势 燎原之火 燎泡 燎炬
幢	幢 幢幢
朕	朕 朕兆
绚	绚 绚丽 绚烂 绚丽多彩 绚丽夺目 绚丽多姿
澎	澎 澎湃 澎湖湾 澎湖 澎湃汹涌 澎湖列岛
侥	侥 侥幸 侥幸心理 侥幸获胜 侥幸取胜
侥	侥 侥幸 侥幸心理 侥幸获胜 侥幸取胜
呱	呱 呱呱 呱呱叫 呱唧 呱呱坠地 呱嗒
淤	淤 淤血 淤泥 淤积 淤塞 淤沙
伶	伶 伶俐 伶牙俐齿 伶仃 伶人 伶牙利齿
挟	挟 挟持 挟着 挟裹 挟带 挟天子以令诸侯
娄	娄 娄子 娄底 娄山关 娄金狗 娄宿
趾	趾 趾高气扬 趾高气昂 趾甲 趾骨 趾头
彰	彰 彰显 彰扬 彰武市 彰德 彰化
镯	镯 镯子
襟	襟 襟怀 襟翼 襟里 襟怀坦荡 襟怀坦白
吨	吨 吨位 吨重 吨级 吨数 吨粮县
梢	梢 梢头 梢子 梢公 梢门 梢枝
薰	薰 薰衣草 薰香 薰风 薰陶 薰天
伽	伽 伽马 伽蓝 伽马射线 伽利略 伽达默尔
伽	伽 伽马 伽蓝 伽马射线 伽利略 伽达默尔
伽	伽 伽马 伽蓝 伽马射线 伽利略 伽达默尔
蓓	蓓 蓓蕾 蓓尔
邋	邋 邋遢 邋里邋遢
睦	睦 睦邻 睦邻友好 睦邻关系 睦邻政策 睦亲
橡	橡 橡皮 橡胶 橡皮筋 橡树 橡皮擦
磋	磋 磋商 磋磨 磋谈
惟	惟 惟一 惟妙惟肖 惟有 惟独 惟恐
挎	挎 挎包 挎着 挎枪 挎斗
墩	墩 墩子 墩布 墩台 墩墩实实
哩	哩 哩哩啦啦 哩哩啰啰 哩噜
羁	羁 羁绊 羁押 羁旅 羁留 羁縻
缪	缪 缪荃孙 缪云台 缪昌期 缪文远 缪种流传
槐	槐 槐树 槐花 槐树下 槐木 槐林
噪	噪 噪音 噪杂 噪声 噪响 噪声污染
旱	旱 旱烟 旱魃 旱地 旱鸭子 旱灾
恺	恺 恺撒 恺撒大帝 恺切
簇	簇 簇拥 簇拥着 簇簇 簇新 簇拥而上
铸	铸 铸造 铸就 铸成 铸铁 铸币
昵	昵 昵称
斐	斐 斐然 斐济 斐然成章 斐尔 斐济共和国
疆	疆 疆域 疆土 疆场 疆界 疆吏
聆	聆 聆听 聆讯 聆音察理 聆教 聆赏
璀	璀 璀璨 璀璨夺目 璀灿 璀燦
窦	窦 窦建德 窦娥冤 窦太后 窦尔墩 窦天章
殆	殆 殆尽 殆及 殆盡
矢	矢 矢口否认 矢量 矢志不渝 矢口 矢车菊
掂	掂 掂量 掂量掂量 掂出 掂掇 掂斤播两
咂	咂 咂嘴 咂咂嘴 咂巴 咂摸 咂嘴舔唇
腼	腼 腼腆 腼颜事敌 腼颜天壤 腼然
屡	屡 屡屡 屡次 屡见不鲜 屡试不爽 屡教不改
唏	唏 唏嘘 唏噓
赎	赎 赎罪 赎金 赎回 赎人 赎身
掷	掷 掷地有声 掷骰子 掷弹筒 掷弹 掷铁饼
沓	沓 沓至 沓杂
沓	沓 沓至 沓杂
旨	旨 旨意 旨在 旨趣 旨归 旨酒嘉肴
獠	獠 獠牙
哐	哐 哐当 哐啷
券	券 券商 券门 券面 券种
券	券 券商 券门 券面 券种
驭	驭 驭者 驭手 驭夫
偎	偎 偎依 偎着 偎抱 偎倚 偎傍
荧	荧 荧光 荧幕 荧屏 荧光棒 荧光灯
峙	峙 峙立
峙	峙 峙立
沥	沥 沥青 沥沥 沥青路面 沥青路 沥城
嗝	嗝 嗝儿
俨	俨 俨然 俨如 俨乎其然 俨若
踱	踱 踱步 踱去 踱来 踱方步
炕	炕 炕头 炕沿 炕桌 炕席 炕下
矣	矣 矣哉
缴	缴 缴费 缴纳 缴械投降 缴获 缴费单
缴	缴 缴费 缴纳 缴械投降 缴获 缴费单
傀	傀 傀儡 傀儡政权 傀儡政府 傀儡戏
颂	颂 颂歌 颂扬 颂词 颂德 颂赞
洼	洼 洼地 洼里 洼田 洼陷
馋	馋 馋猫 馋嘴 馋鬼 馋涎欲滴 馋涎
栈	栈 栈道 栈桥 栈房 栈恋 栈单
迦	迦 迦南 迦太基 迦勒 迦南人 迦纳
喏	喏 喏喏连声
喏	喏 喏喏连声
寅	寅 寅时 寅虎 寅吃卯粮 寅支卯粮
戟	戟 戟指怒目
曳	曳 曳引机 曳光弹 曳光 曳尾涂中 曳裾王门
靳	靳 靳云鹏 靳羽西 靳尚宜 靳尚谊
窘	窘 窘迫 窘境 窘态 窘状 窘相
禄	禄 禄星 禄位 禄丰 禄劝 禄劝县
梗	梗 梗着 梗死 梗概 梗塞 梗住
殃	殃 殃及池鱼 殃及 殃民 殃及无辜 殃咎
飒	飒 飒飒 飒爽 飒爽英姿 飒然 飒飒声
蚕	蚕 蚕食 蚕豆 蚕丝 蚕茧 蚕蛹
谍	谍 谍报 谍报人员 谍报员 谍中谍
匣	匣 匣子 匣钵 匣子枪 匣式
蒜	蒜 蒜苗 蒜头 蒜蓉 蒜泥 蒜瓣
敦	敦 敦实 敦厚 敦煌 敦促 敦敦
诫	诫 诫命 诫律 诫勉 诫条
辽	辽 辽阔 辽宁 辽远 辽东 辽河
缀	缀 缀补 缀连 缀网 缀点 缀合
蹊	蹊 蹊跷 蹊径
蹊	蹊 蹊跷 蹊径
靴	靴 靴子 靴尖 靴底 靴鞋 靴钉
霹	霹 霹雳 霹雳舞 霹雷 霹雳火 霹雳炮
骸	骸 骸骨
磅	磅 磅礴 磅秤 磅重 磅称 磅房
磅	磅 磅礴 磅秤 磅重 磅称 磅房
蹿	蹿 蹿出 蹿到 蹿升 蹿红 蹿跳
鳄	鳄 鳄鱼 鳄鱼皮 鳄鱼眼泪 鳄鱼湖 鳄梨
蝼	蝼 蝼蚁 蝼蛄 蝼蝈
嵩	嵩 嵩山 嵩山少林寺 嵩明 嵩县 嵩明县
醺	醺 醺醺 醺醺然
鸢	鸢 鸢尾 鸢尾花 鸢飞鱼跃 鸢肩豺目 鸢鹰
俭	俭 俭朴 俭以养德 俭用 俭省 俭约
圳	圳 圳沟
臻	臻 臻于完善 臻于极致
钝	钝 钝器 钝响 钝钝 钝兵挫锐 钝刀
弩	弩 弩箭 弩弓 弩机 弩手 弩张剑拔
芹	芹 芹菜 芹菜汤
洽	洽 洽谈 洽谈会 洽谈室 洽询 洽商
灸	灸 灸法 灸术
斋	斋 斋饭 斋戒 斋藤 斋菜 斋主
钳	钳 钳子 钳制 钳工 钳夹 钳口
壤	壤 壤土 壤塘 壤塘县
黠	黠 黠戛斯 黠慧
嚏	嚏 嚏喷
堤	堤 堤坝 堤上 堤岸 堤防 堤道
冈	冈 冈山县 冈田 冈山 冈崎 冈峦
榴	榴 榴莲 榴弹 榴弹炮 榴花 榴槤
倘	倘 倘若 倘使 倘佯 倘然 倘或
榆	榆 榆木 榆树 榆木脑袋 榆木疙瘩 榆林
倘	倘 倘若 倘使 倘佯 倘然 倘或
恙	恙 恙虫
瓢	瓢 瓢泼大雨 瓢泼 瓢虫 瓢儿 瓢子
泻	泻 泻药 泻火 泻下 泻下来 泻出
羿	羿 羿射九日
蕉	蕉 蕉叶 蕉岭 蕉园 蕉麻 蕉城区
骰	骰 骰子
呻	呻 呻吟 呻吟声 呻唤
乒	乒 乒乓球 乒乒乓乓 乒乓球台 乒乓 乒乓球桌
鞘	鞘 鞘翅 鞘翅目
鞘	鞘 鞘翅 鞘翅目
曝	曝 曝光 曝晒 曝光率 曝露 曝气
曝	曝 曝光 曝晒 曝光率 曝露 曝气
蔷	蔷 蔷薇 蔷薇花 蔷薇科 蔷薇骑士
隧	隧 隧道 隧道口 隧洞 隧道窑
庇	庇 庇护 庇佑 庇护所 庇荫 庇護
惆	惆 惆怅 惆然 惆悵
弑	弑 弑父 弑君
淮	淮 淮南 淮安 淮河 淮山 淮海
蘑	蘑 蘑菇 蘑菇云 蘑菇状 蘑菇石
厥	厥 厥阴 厥功甚伟 厥为 厥证 厥阴俞
坝	坝 坝子 坝上 坝头 坝顶 坝体
肴	肴 肴馔
褐	褐 褐色 褐红色 褐黑色 褐斑病 褐铁矿
跋	跋 跋扈 跋涉 跋山涉水 跋扈飞扬 跋语
哔	哔 哔哩啪啦 哔哔声 哔叽
肮	肮 肮脏 肮脏交易 肮脏鬼 肮肮脏脏 肮里肮脏
菡	菡 菡萏 菡子
猖	猖 猖狂 猖獗 猖狂进攻 猖獗一时
簸	簸 簸箕 簸箩 簸弄 簸荡 簸谷
卒	卒 卒子 卒业 卒岁
卒	卒 卒子 卒业 卒岁
蠕	蠕 蠕动 蠕虫 蠕蠕 蠕動 蠕行
痘	痘 痘痘 痘子 痘疮 痘疹 痘瘡
裔	裔 裔胄
迭	迭 迭起 迭出 迭戈 迭部 迭代
坨	坨 坨子
乓	乓 乓乓
忿	忿 忿忿 忿忿不平 忿恨 忿怒 忿然
韬	韬 韬光养晦 韬略 韬晦 韬光 韬奋
陛	陛 陛下
颁	颁 颁发 颁布 颁奖 颁奖典礼 颁奖礼
缅	缅 缅怀 缅甸 缅因州 缅甸政府 缅因
轶	轶 轶事 轶闻 轶诗
拷	拷 拷问 拷贝 拷打 拷贝到 拷机
绫	绫 绫罗绸缎 绫罗 绫子 绫绢 绫波丽
琥	琥 琥珀 琥珀色 琥珀酸
仨	仨 仨月 仨俩
嫦	嫦 嫦娥 嫦娥奔月
寇	寇 寇仇 寇振海 寇准 寇谦之 寇莱公
渝	渝 渝州 渝水 渝北 渝北区 渝中区
雍	雍 雍容华贵 雍容 雍正 雍和宫 雍正年间
戎	戎 戎装 戎马 戎马一生 戎马生涯 戎马倥偬
绸	绸 绸缎 绸布 绸带 绸子 绸缎庄
癖	癖 癖好 癖性 癖习
嗲	嗲 嗲声嗲气 嗲地 嗲得
煽	煽 煽情 煽动 煽风点火 煽动性 煽动力
冀	冀 冀州 冀北 冀东 冀望 冀中
茸	茸 茸毛 茸茸
瞌	瞌 瞌睡 瞌睡虫
荀	荀 荀彧 荀子 荀文若 荀林父 荀慧生
虔	虔 虔诚 虔诚地 虔敬 虔心 虔婆
苛	苛 苛刻 苛责 苛求 苛捐杂税 苛政
禀	禀 禀报 禀告 禀明 禀性 禀性难移
咄	咄 咄咄逼人 咄咄 咄咄怪事 咄嗟 咄咄书空
荤	荤 荤菜 荤腥 荤段子 荤油 荤笑话
楷	楷 楷模 楷书 楷体 楷体字 楷字
楷	楷 楷模 楷书 楷体 楷体字 楷字
拗	拗 拗不过 拗口 拗断 拗劲 拗折
拗	拗 拗不过 拗口 拗断 拗劲 拗折
枣	枣 枣树 枣子 枣红色 枣核 枣红马
刨	刨 刨根问底 刨出来 刨土 刨除 刨冰
萦	萦 萦绕 萦绕在 萦回 萦怀 萦纡
刨	刨 刨根问底 刨出来 刨土 刨除 刨冰
锥	锥 锥子 锥心 锥形 锥刺股 锥体
倭	倭 倭寇 倭奴 倭瓜 倭寇船
袅	袅 袅袅 袅娜 袅袅婷婷 袅袅娜娜 袅绕
皎	皎 皎洁 皎白 皎然 皎阳似火
耕	耕 耕种 耕地 耕耘 耕田 耕作
螃	螃 螃蟹 螃蟹壳 螃蟹肉
岑	岑 岑溪 岑寂 岑凯伦 岑大人 岑建勋
憎	憎 憎恨 憎恶 憎厌 憎嫌 憎嫉
缥	缥 缥缈 缥渺
酝	酝 酝酿 酝藉 酝成
珀	珀 珀尔 珀斯 珀西 珀蒂 珀金
扉	扉 扉页 扉画
糯	糯 糯米 糯米饭 糯米酒 糯米糕 糯米粉
煦	煦 煦和 煦煦
淬	淬 淬炼 淬火 淬砺 淬鍊 淬透性
鳖	鳖 鳖甲 鳖肉 鳖鱼 鳖精 鳖边
跷	跷 跷课 跷跷板 跷着 跷起 跷跷
睽	睽 睽睽 睽违 睽离 睽隔多年 睽違
鸳	鸳 鸳鸯 鸳鸯浴 鸳鸯蝴蝶 鸳鸯戏水 鸳鸯锅
叩	叩 叩首 叩头 叩拜 叩响 叩门
仕	仕 仕途 仕女图 仕女 仕宦 仕女画
晾	晾 晾晒 晾干 晾着 晾衣服 晾衣架
靶	靶 靶子 靶场 靶心 靶位 靶向
窑	窑 窑洞 窑子 窑厂 窑口 窑主
溶	溶 溶洞 溶解 溶液 溶化 溶入
坷	坷 坷垃
狩	狩 狩猎 狩猎者 狩猎场 狩野 狩獵
鬓	鬓 鬓角 鬓发 鬓毛 鬓边 鬓霜
嬴	嬴 嬴政
曙	曙 曙光 曙色 曙光路 曙目 曙光乍现
猝	猝 猝不及防 猝死 猝然 猝发 猝倒
丙	丙 丙级 丙辰 丙申 丙午 丙寅
赘	赘 赘肉 赘述 赘言 赘婿 赘物
剖	剖 剖析 剖开 剖腹产 剖腹 剖成
吝	吝 吝啬 吝惜 吝啬鬼 吝色 吝舍
秽	秽 秽物 秽语 秽气 秽乱 秽土
辗	辗 辗转 辗转反侧 辗转难眠 辗平 辗过
玺	玺 玺印
蚩	蚩 蚩尤 蚩尤寨
芜	芜 芜湖 芜杂 芜湖市 芜秽 芜菁
奚	奚 奚落 奚啸伯 奚美娟 奚长老 奚国华
贬	贬 贬低 贬值 贬义词 贬义 贬斥
芮	芮 芮乃伟 芮城县 芮良夫 芮城 芮晓武
筛	筛 筛选 筛子 筛糠 筛查 筛网
讷	讷 讷讷 讷河 讷口少言 讷言敏行 讷河市
赦	赦 赦免 赦令 赦免令 赦罪 赦免权
牟	牟 牟利 牟取 牟取暴利 牟其中 牟定
剁	剁 剁成 剁碎 剁肉
褶	褶 褶皱 褶子 褶裙 褶边 褶痕
谄	谄 谄媚 谄笑 谄谀 谄媚者 谄害
菌	菌 菌类 菌子 菌丝 菌种 菌落
姣	姣 姣好 姣美 姣丽 姣妻 姣娘
簌	簌 簌簌 簌地 簌簌泪下
旬	旬 旬阳 旬邑 旬日 旬阳县 旬刊
驯	驯 驯服 驯养 驯化 驯兽 驯兽师
驹	驹 驹子
瞿	瞿 瞿秋白 瞿式耜 瞿塘峡 瞿大人 瞿北杨
皂	皂 皂荚 皂白 皂化 皂白分明 皂靴
耷	耷 耷拉
牡	牡 牡丹 牡丹花 牡蛎 牡丹江 牡丹园
撵	撵 撵走 撵出去 撵出 撵出来 撵去
诽	诽 诽谤 诽谤罪 诽议 诽谤之木 诽谤者
粟	粟 粟子 粟米 粟裕 粟饭 粟一石
眺	眺 眺望 眺望塔 眺望楼 眺览 眺望台
垒	垒 垒砌 垒墙 垒土 垒上 垒球
寰	寰 寰宇 寰球 寰岛 寰海
锄	锄 锄头 锄草 锄强扶弱 锄地 锄禾
槛	槛 槛车 槛墙
戛	戛 戛然而止 戛然 戛纳 戛戛独造 戛玉敲冰
槛	槛 槛车 槛墙
咫	咫 咫尺 咫尺天涯 咫尺之遥 咫尺之间 咫尺千里
紊	紊 紊乱 紊乱如麻 紊流
褥	褥 褥子 褥单 褥疮 褥垫 褥套
撮	撮 撮合 撮箕 撮子 撮要 撮土
栅	栅 栅栏 栅栏门 栅极 栅门 栅子
撮	撮 撮合 撮箕 撮子 撮要 撮土
栅	栅 栅栏 栅栏门 栅极 栅门 栅子
咨	咨 咨询 咨询台 咨询室 咨询师 咨询电话
宪	宪 宪法 宪宗 宪兵 宪政 宪兵队
阑	阑 阑珊 阑尾炎 阑尾 阑干 阑珊处
斟	斟 斟酌 斟满 斟酒 斟上 斟茶
芭	芭 芭比娃娃 芭蕉 芭比 芭蕾舞 芭蕾
粤	粤 粤语 粤省 粤语歌 粤东 粤菜
撬	撬 撬开 撬棍 撬动 撬锁 撬门
佼	佼 佼佼者 佼佼
辍	辍 辍学 辍学生 辍笔 辍学率 辍耕
龌	龌 龌龊 龌龊事
踝	踝 踝关节 踝骨 踝子骨
飕	飕 飕飕
淅	淅 淅淅沥沥 淅沥沥 淅沥 淅淅 淅川
咀	咀 咀嚼 咀咒 咀嚼出 咀嚼运动 咀嚼片
咀	咀 咀嚼 咀咒 咀嚼出 咀嚼运动 咀嚼片
瞩	瞩 瞩目 瞩望 瞩托
闸	闸 闸门 闸口 闸刀 闸北 闸刀开关
荼	荼 荼毒 荼毒生灵
杵	杵 杵臼
冶	冶 冶金 冶炼 冶炼厂 冶艳 冶铁
榕	榕 榕树 榕城 榕树下 榕江 榕樹
泯	泯 泯灭 泯没 泯滅
滕	滕 滕王阁 滕文公 滕县 滕子京 滕州
裘	裘 裘千尺 裘皮 裘千仞 裘千丈 裘盛戎
彷	彷 彷徨 彷佛 彷如 彷彿 彷徉
彷	彷 彷徨 彷佛 彷如 彷彿 彷徉
锵	锵 锵锵
昼	昼 昼夜 昼伏夜出 昼短夜长 昼长夜短 昼夜不息
椎	椎 椎骨 椎体 椎间盘 椎心泣血 椎管
椎	椎 椎骨 椎体 椎间盘 椎心泣血 椎管
砌	砌 砌成 砌墙 砌砖 砌筑 砌石
枢	枢 枢纽 枢机 枢机主教 枢纽站 枢要
甥	甥 甥舅 甥儿 甥女
慷	慷 慷慨 慷慨激昂 慷慨解囊 慷慨就义 慷慨陈词
雏	雏 雏形 雏鹰 雏菊 雏儿 雏鸟
翱	翱 翱翔 翱翔天空 翱翔天际 翱游 翱游四海
亵	亵 亵渎 亵玩 亵渎神明 亵衣 亵慢
辖	辖 辖区 辖下 辖制 辖境 辖属
蟑	蟑 蟑螂 蟑螂乐队
扈	扈 扈从 扈三娘 扈驾亲 扈家庄 扈太公
闵	闵 闵行区 闵采尔 闵园竹 闵行校 闵师弟
懿	懿 懿旨 懿德 懿行 懿范
涅	涅 涅槃 涅盘 涅瓦 涅盤 涅米宁
忒	忒 忒楞楞
鲸	鲸 鲸鱼 鲸吞 鲸鲨 鲸油 鲸吞蚕食
恪	恪 恪守 恪尽职守 恪尽 恪守不渝 恪尽职责
淀	淀 淀粉 淀粉酶 淀粉类 淀粉样变 淀粉厂
凿	凿 凿开 凿子 凿出 凿凿 凿出来
蛾	蛾 蛾子 蛾眉 蛾眉皓齿 蛾眉粉黛 蛾眉螓首
栓	栓 栓子 栓塞 栓牢 栓皮栎 栓皮
贿	贿 贿赂 贿款 贿选 贿赂案 贿买
勘	勘 勘察 勘查 勘测 勘探 勘探队
佯	佯 佯装 佯攻 佯装不知 佯嗔 佯笑
榨	榨 榨菜 榨取 榨汁机 榨出 榨油
颐	颐 颐指气使 颐养天年 颐和园 颐养 颐和
浙	浙 浙江 浙大 浙省 浙江省 浙江人
橱	橱 橱窗 橱柜 橱子 橱柜门
冕	冕 冕服 冕旒 冕宁 冕宁县 冕牌玻璃
瘟	瘟 瘟神 瘟疫 瘟鸡 瘟病 瘟到死
烘	烘 烘烤 烘托 烘干 烘焙 烘培
锯	锯 锯齿 锯子 锯断 锯开 锯齿状
胯	胯 胯下 胯部 胯下之辱 胯骨 胯里
峡	峡 峡谷 峡口 峡山 峡县 峡江
痊	痊 痊愈 痊癒
卯	卯 卯足了劲 卯足 卯时 卯上 卯兔
丞	丞 丞相
疵	疵 疵点 疵议 疵瑕 疵品
嗑	嗑 嗑瓜子
捺	捺 捺印
郡	郡 郡主 郡王 郡守 郡县 郡王府
俘	俘 俘虏 俘获 俘虏营 俘敌
鸾	鸾 鸾鸟 鸾凤 鸾凤和鸣 鸾颠凤倒 鸾姿凤态
疮	疮 疮痍 疮疤 疮口 疮痍满目 疮痂
佘	佘 佘太君 佘一元 佘诗曼 佘祥林
噶	噶 噶尔丹 噶尔 噶伦堡 噶伦 噶厦
萤	萤 萤火虫 萤火 萤光 萤石 萤幕上
峨	峨 峨眉 峨眉山 峨嵋 峨嵋派 峨嵋山
栾	栾 栾城 栾南 栾川 栾布击 栾城县
苔	苔 苔藓 苔丝 苔衣 苔原 苔藓植物
舆	舆 舆论 舆论压力 舆图 舆情 舆论导向
巩	巩 巩固 巩膜 巩俐 巩县 巩固政权
酌	酌 酌情 酌酒 酌情处理 酌定 酌量
溯	溯 溯源 溯流 溯流而上 溯江而上 溯本求源
硝	硝 硝烟 硝烟弥漫 硝烟味 硝酸甘油 硝酸
讹	讹 讹诈 讹人 讹言 讹传 讹误
谴	谴 谴责
簧	簧 簧片 簧乐器 簧管 簧风琴
羔	羔 羔羊 羔子 羔裘 羔羊皮 羔皮
孜	孜 孜孜不倦 孜然 孜孜 孜孜以求 孜孜追求
垢	垢 垢污 垢面蓬头 垢泥
苇	苇 苇子 苇河 苇塘 苇草 苇席
螳	螳 螳螂 螳螂捕蝉 螳臂当车 螳螂拳 螳臂挡车
剿	剿 剿灭 剿匪 剿杀 剿除 剿共
栖	栖 栖息 栖身 栖息地 栖身之地 栖居
剿	剿 剿灭 剿匪 剿杀 剿除 剿共
醇	醇 醇厚 醇香 醇酒 醇正 醇和
栖	栖 栖息 栖身 栖息地 栖身之地 栖居
剃	剃 剃着 剃须刀 剃头 剃刀 剃度
饲	饲 饲料 饲养 饲养员 饲主 饲草
筠	筠 筠连 筠连县
筠	筠 筠连 筠连县
屹	屹 屹立 屹然 屹立不动 屹立不摇 屹立不搖
芥	芥 芥蒂 芥末 芥子 芥兰 芥菜
芥	芥 芥蒂 芥末 芥子 芥兰 芥菜
矗	矗 矗立 矗起
龇	龇 龇牙咧嘴 龇牙 龇牙裂嘴
槟	槟 槟榔 槟城 槟子 槟榔汁
蜕	蜕 蜕变 蜕皮 蜕化 蜕壳 蜕化变质
笋	笋 笋丝 笋干 笋子 笋壳 笋尖
砚	砚 砚台 砚石 砚池 砚山 砚山县
隋	隋 隋朝 隋菲菲 隋唐 隋炀帝 隋末唐
舵	舵 舵主 舵手 舵盘 舵轮 舵工
酣	酣 酣睡 酣畅淋漓 酣然 酣畅 酣战
稠	稠 稠密 稠乎乎 稠粥 稠子 稠糊
沪	沪 沪市 沪江 沪东 沪深股市 沪剧
啄	啄 啄米 啄食 啄木鸟 啄木 啄起
鹦	鹦 鹦鹉 鹦鹉螺 鹦鹉学舌 鹦哥 鹦哥绿
媲	媲 媲美
奠	奠 奠定 奠基 奠基人 奠仪 奠基石
纺	纺 纺织 纺织厂 纺织品 纺车 纺纱
凋	凋 凋零 凋谢 凋落 凋亡 凋敝
莘	莘 莘莘学子 莘县 莘莘學子
篆	篆 篆体 篆字 篆书 篆刻 篆文
甭	甭 甭管 甭想 甭提 甭说
扼	扼 扼杀 扼住 扼腕叹息 扼腕 扼守
嘤	嘤 嘤其鸣矣
弛	弛 弛缓 弛懈 弛豫
孰	孰 孰不可忍 孰轻孰重 孰能无过 孰能无情 孰料
遐	遐 遐想 遐思 遐迩 遐迩闻名 遐龄
炊	炊 炊烟 炊烟袅袅 炊事班 炊具 炊事员
涎	涎 涎水 涎着脸 涎液 涎皮涎脸 涎皮赖脸
遏	遏 遏制 遏止 遏止住 遏抑 遏阻
蜈	蜈 蜈蚣 蜈蚣洞 蜈蚣草 蜈支洲岛
匾	匾 匾额 匾牌 匾联 匾文
辘	辘 辘辘 辘轳
锣	锣 锣鼓 锣鼓喧天 锣声 锣鼓声 锣鼓队
帚	帚 帚柄 帚子
惘	惘 惘然 惘然若失
抉	抉 抉择 抉擇 抉摘 抉奥阐幽
惰	惰 惰性 惰性气体 惰性元素
箍	箍 箍紧 箍桶 箍头 箍桶匠
叱	叱 叱咤风云 叱咤 叱喝 叱诧风云 叱骂
峭	峭 峭壁 峭拔 峭立 峭寒 峭直
屯	屯 屯子 屯里 屯兵 屯门 屯粮
屯	屯 屯子 屯里 屯兵 屯门 屯粮
昙	昙 昙花一现 昙花
貂	貂 貂蝉 貂皮 貂皮大衣 貂鼠 貂裘
掖	掖 掖县 掖进
蔫	蔫 蔫蔫 蔫头耷脑 蔫儿坏 蔫巴 蔫巴巴
庚	庚 庚辰 庚午 庚申 庚寅 庚子
踮	踮 踮起 踮着 踮脚 踮脚眺望
祠	祠 祠堂 祠庙 祠墓
肇	肇 肇事 肇事者 肇事车 肇事人 肇事案
邂	邂 邂逅 邂逅相遇 邂逅相逢
饕	饕 饕餮 饕餮之徒
籽	籽 籽儿 籽种 籽粒 籽棉 籽实
娓	娓 娓娓道来 娓娓 娓娓动听 娓娓而谈 娓娓不倦
亘	亘 亘古 亘古不灭 亘古未有 亘古通今 亘古亘今
涣	涣 涣散 涣然 涣然冰释 涣然一新
忡	忡 忡忡
臊	臊 臊子 臊气
簿	簿 簿子 簿册 簿记员 簿记 簿籍
珞	珞 珞巴 珞珈 珞珈山 珞狮 珞巴族
伫	伫 伫立 伫足 伫候
芋	芋 芋头 芋艿 芋頭
穗	穗 穗子 穗城 穗儿 穗状 穗状花序
亓	亓 亓诗教
俐	俐 俐落
韶	韶 韶华 韶关 韶光 韶山 韶华易
窖	窖 窖藏 窖子 窖洞 窖酒
踌	踌 踌躇 踌躇满志 踌躇不前 踌蹰 踌躇不决
稼	稼 稼穑 稼穑艰难 稼穡
趔	趔 趔趄 趔趔趄趄
瘤	瘤 瘤子 瘤胃 瘤牛
蜗	蜗 蜗牛 蜗居 蜗壳 蜗角 蜗行牛步
咿	咿 咿呀 咿咿呀呀 咿呀学语 咿哑 咿哑学语
枷	枷 枷锁 枷鎖
吠	吠 吠叫 吠声 吠陀 吠舍 吠檀多
冼	冼 冼星海
沼	沼 沼泽 沼泽地 沼气 沼气池 沼泽地带
碳	碳 碳素 碳酸 碳化 碳水化合物 碳纤维
翌	翌 翌日 翌年
怦	怦 怦然心动 怦怦 怦然 怦怦直跳
渎	渎 渎职 渎职罪 渎职犯罪 渎职侵权
匡	匡 匡扶 匡扶汉 匡正 匡衡凿壁 匡救
藐	藐 藐视 藐视一切 藐小
汀	汀 汀娜 汀江 汀州 汀泗桥 汀洲
赃	赃 赃物 赃款 赃车 赃官 赃款赃物
衙	衙 衙门 衙役 衙内 衙署 衙前
幡	幡 幡然醒悟 幡然悔悟 幡然 幡儿 幡然改途
祀	祀 祀神 祀祖 祀奉 祀事
喀	喀 喀嚓 喀秋莎 喀拉 喀什 喀拉拉
佰	佰 佰草集
拣	拣 拣起 拣到 拣出 拣去 拣拾
阙	阙 阙如 阙至尊 阙疑 阙左门 阙文
弋	弋 弋阳 弋获 弋阳腔
於	於 於是 於此 於紫微 於心不忍 於梨华
於	於 於是 於此 於紫微 於心不忍 於梨华
恃	恃 恃强凌弱 恃才傲物 恃宠而骄 恃强欺弱 恃才自傲
熔	熔 熔炉 熔岩 熔炼 熔化 熔融
岐	岐 岐山 岐黄 岐路 岐视 岐义
盅	盅 盅子
汶	汶 汶川 汶山 汶水 汶上 汶川县
羹	羹 羹匙 羹汤 羹饭
饵	饵 饵料 饵食 饵名钓禄 饵敌
拄	拄 拄着 拄杖
募	募 募捐 募集 募得 募捐箱 募兵
倏	倏 倏地 倏然 倏忽 倏尔 倏忽之间
熹	熹 熹微 熹平 熹宗
襄	襄 襄阳 襄王 襄理 襄樊 襄城
迂	迂 迂腐 迂回 迂回曲折 迂回战术 迂直
嫡	嫡 嫡系 嫡传 嫡孙 嫡子 嫡亲
坂	坂 坂崎由莉 坂本龙 坂田荣男 坂崎良
攸	攸 攸关 攸然 攸攸之口 攸县 攸關
蜒	蜒 蜒蚰
谩	谩 谩骂 谩骂者
盎	盎 盎然 盎司 盎格鲁 盎斯
蜿	蜿 蜿蜒
渲	渲 渲染 渲泄 渲染法 渲染器
蔺	蔺 蔺相如 蔺草
谬	谬 谬赞 谬论 谬误 谬以千里 谬之千里
帷	帷 帷幕 帷帐 帷幔 帷幄 帷子
捎	捎 捎带 捎来 捎信 捎去 捎话
骅	骅 骅骝
榻	榻 榻榻米 榻板
诬	诬 诬陷 诬赖 诬告 诬蔑 诬赖好人
啜	啜 啜泣 啜泣声 啜饮 啜泣聲 啜菽饮水
垄	垄 垄断 垄沟 垄断性 垄断行业 垄作
辐	辐 辐射 辐射强度 辐射状 辐射源 辐条
胚	胚 胚子 胚胎 胚芽 胚根 胚体
篱	篱 篱笆 篱笆墙 篱下 篱墙 篱竹
炳	炳 炳灵 炳发 炳炳烺烺 炳烛夜游 炳如日星
煲	煲 煲汤 煲仔饭
冢	冢 冢中枯骨 冢木已拱
毋	毋 毋庸置疑 毋庸 毋须 毋宁死 毋需
潺	潺 潺潺 潺潺流水
泌	泌 泌出 泌尿系统 泌尿 泌尿科 泌尿系
泌	泌 泌出 泌尿系统 泌尿 泌尿科 泌尿系
畴	畴 畴昔
沅	沅 沅水 沅江 沅陵 沅芷湘兰 沅陵县
庐	庐 庐山 庐山真面目 庐州 庐陵 庐山真面
粼	粼 粼粼 粼粼碧波
忖	忖 忖道 忖度 忖量
篝	篝 篝火 篝火狐鸣
抒	抒 抒发 抒情 抒写 抒情诗 抒情歌曲
轲	轲 轲比能
虏	虏 虏获 虏掠
蛰	蛰 蛰伏 蛰虫 蛰居 蛰雷
蜻	蜻 蜻蜓 蜻蜓点水 蜻蜒点水 蜻蜒 蜻蛉
俟	俟 俟河之清 俟机
篓	篓 篓子 篓筐
俟	俟 俟河之清 俟机
涮	涮 涮羊肉 涮锅 涮洗 涮锅子 涮涮锅
忏	忏 忏悔 忏悔录 忏悔书 忏悔者
礁	礁 礁石 礁岩 礁堡 礁屿 礁盘
婀	婀 婀娜 婀娜多姿
铿	铿 铿锵有力 铿锵 铿铿 铿锵声 铿然
粽	粽 粽子 粽粑
璧	璧 璧山 璧玉 璧月 璧山县 璧合
桓	桓 桓台 桓玄 桓帝延 桓彦范 桓公之
瀛	瀛 瀛洲 瀛州 瀛台 瀛海 瀛寰
鼾	鼾 鼾声 鼾声如雷 鼾睡 鼾息 鼾息声
苞	苞 苞米 苞谷 苞片
滤	滤 滤过 滤清 滤嘴 滤光 滤镜
蹂	蹂 蹂躏
蜥	蜥 蜥蜴 蜥蜴人 蜥蜴毒 蜥蝪 蜥脚类
煊	煊 煊赫
栀	栀 栀子花 栀子
浒	浒 浒墅关 浒山
咎	咎 咎由自取 咎有应得
浒	浒 浒墅关 浒山
捻	捻 捻起 捻灭 捻转 捻子 捻须
瞻	瞻 瞻仰 瞻前顾后 瞻望 瞻养 瞻拜
雌	雌 雌性 雌雄 雌雄同体 雌性激素 雌威
瓮	瓮 瓮声瓮气 瓮中捉鳖 瓮中之鳖 瓮中 瓮城
蹒	蹒 蹒跚 蹒跚而行 蹒跚行走
嫖	嫖 嫖客 嫖妓 嫖赌 嫖娼 嫖宿
阀	阀 阀门 阀门厂 阀体 阀值 阀阅
潼	潼 潼关 潼南 潼南县 潼关县
娑	娑 娑婆 娑罗树 娑罗子 娑罗双树
搪	搪 搪塞 搪瓷 搪瓷厂 搪瓷制品 搪塑
鱿	鱿 鱿鱼 鱿鱼丝 鱿鱼干 鱿鱼片
秧	秧 秧苗 秧子 秧歌 秧田 秧歌队
鲲	鲲 鲲鹏 鲲鹏展翅
柬	柬 柬埔寨 柬帖 柬埔寨人 柬埔寨语 柬埔寨王国
璞	璞 璞玉 璞鼎查 璞玉浑金
鸥	鸥 鸥鸟 鸥鹭忘机
迢	迢 迢迢 迢遥 迢迢千里 迢迢万里 迢远
磐	磐 磐石 磐安 磐田 磐石之固
诠	诠 诠释 诠释者 诠注 诠才末学 诠次
毓	毓 毓秀 毓璜顶 毓婷
浠	浠 浠水 浠水县
夔	夔 夔门 夔龙 夔龍
栎	栎 栎树 栎阳 栎木 栎阳雨金
飓	飓 飓风
栎	栎 栎树 栎阳 栎木 栎阳雨金
湮	湮 湮灭 湮没 湮没无闻 湮灭证据 湮沒
逾	逾 逾越 逾期 逾时 逾常 逾越节
濒	濒 濒临 濒死 濒临灭绝 濒危 濒临破产
佝	佝 佝偻 佝偻病 佝僂
皑	皑 皑皑
阐	阐 阐述 阐释 阐明 阐发 阐扬
烹	烹 烹饪 烹制 烹调 烹煮 烹茶
瞑	瞑 瞑目 瞑想 瞑思苦想
卤	卤 卤肉 卤蛋 卤菜 卤鸡 卤水
粱	粱 粱山 粱肉
痰	痰 痰盂 痰饮 痰喘 痰迹 痰气
坍	坍 坍塌 坍缩 坍台 坍陷 坍倒
惴	惴 惴惴不安 惴惴 惴惴的
拴	拴 拴着 拴住 拴上 拴马 拴紧
胭	胭 胭脂 胭脂粉 胭脂红 胭红 胭脂扣
犷	犷 犷悍
噙	噙 噙齿戴发
纬	纬 纬度 纬线 纬书 纬纱
臃	臃 臃肿 臃腫
涧	涧 涧水 涧溪 涧沟 涧流 涧口
浣	浣 浣熊 浣纱 浣衣 浣洗 浣溪沙
掣	掣 掣肘 掣电 掣襟露肘
诲	诲 诲人不倦 诲淫诲盗 诲淫 诲盗 诲盗诲淫
藕	藕 藕断丝连 藕粉 藕片 藕丝 藕荷
歼	歼 歼灭 歼敌 歼灭战 歼击机 歼击
怏	怏 怏怏 怏怏不乐 怏然 怏怏不悦
缤	缤 缤纷 缤纷多彩 缤纷色彩
椰	椰 椰子 椰子树 椰树 椰城 椰汁
遛	遛 遛弯 遛狗 遛鸟 遛弯儿 遛达
腺	腺 腺体 腺癌 腺苷 腺苷酸 腺嘌呤
鹊	鹊 鹊桥 鹊起 鹊桥会 鹊巢鸠占 鹊桥相会
宓	宓 宓汝成
怵	怵 怵目惊心 怵然 怵头 怵场 怵惕
邸	邸 邸宅 邸阁
腋	腋 腋下 腋窝 腋毛 腋窝下 腋臭
颔	颔 颔首 颔下 颔首微笑 颔联 颔厌
泱	泱 泱泱 泱泱大国 泱泱大风
纶	纶 纶巾 纶巾羽扇 纶音佛语
纶	纶 纶巾 纶巾羽扇 纶音佛语
馍	馍 馍馍
窈	窈 窈窕 窈窕淑女
吏	吏 吏部 吏治 吏员 吏卒 吏目
揶	揶 揶揄
莜	莜 莜麦
匍	匍 匍匐 匍匐前进 匍伏 匍匐运动 匍匐茎
蟾	蟾 蟾蜍 蟾宫 蟾宫折桂 蟾酥 蟾光
蟠	蟠 蟠桃 蟠桃会 蟠龙 蟠螭 蟠龙镇
譬	譬 譬如 譬如说 譬喻 譬若
掸	掸 掸子 掸帚 掸邦
掸	掸 掸子 掸帚 掸邦
钵	钵 钵盂 钵头 钵子
舀	舀 舀水 舀出 舀汤 舀子 舀酒
垣	垣 垣曲 垣曲县
岱	岱 岱庙 岱山 岱宗 岱岳 岱顶
孬	孬 孬种
卞	卞 卞之琳 卞夫人 卞玉京 卞太后 卞德培
夙	夙 夙愿 夙夜 夙兴夜寐 夙夜在公 夙怨
壹	壹 壹号 壹一 壹仟 壹元 壹分
匐	匐 匐伏
玷	玷 玷污 玷辱
樟	樟 樟树 樟树下 樟子松 樟木 樟木箱
馄	馄 馄饨 馄饨面
羚	羚 羚羊 羚羊挂角 羚角 羚牛 羚羊角
殡	殡 殡仪馆 殡葬 殡仪 殡殓 殡车
犒	犒 犒劳 犒赏 犒军 犒赏三军 犒賞
俑	俑 俑坑
濡	濡 濡湿 濡染 濡养
噤	噤 噤声 噤若寒蝉 噤口 噤口痢 噤聲
庶	庶 庶民 庶子 庶出 庶人 庶士
瞠	瞠 瞠目结舌 瞠目 瞠乎其后 瞠目而视
藻	藻 藻类 藻井 藻饰 藻丽 藻類
鸠	鸠 鸠摩智 鸠占鹊巢 鸠形鹄面 鸠山 鸠山由纪夫
缆	缆 缆车 缆绳 缆索 缆线 缆柱
咩	咩 咩咩叫
汕	汕 汕头 汕尾 汕头人 汕头大学 汕头市
豚	豚 豚鼠 豚草
颦	颦 颦眉
搔	搔 搔首弄姿 搔头 搔首 搔痒 搔头皮
柚	柚 柚子 柚子茶 柚木
汩	汩 汩汩
盹	盹 盹儿
衲	衲 衲衣 衲子 衲袄 衲僧
嶙	嶙 嶙峋
耙	耙 耙子 耙地 耙田 耙齿 耙平
伎	伎 伎俩 伎倆
耙	耙 耙子 耙地 耙田 耙齿 耙平
镀	镀 镀金 镀上 镀银 镀锌 镀铬
揖	揖 揖拜 揖谢 揖别 揖让
茨	茨 茨威格 茨冈 茨城 茨城县 茨瓦纳
秤	秤 秤砣 秤杆 秤不离砣 秤钩 秤盘
鹭	鹭 鹭岛 鹭鸟 鹭鸶 鹭鹚
邬	邬 邬倩倩 邬桥真 邬思道 邬君梅 邬贺铨
婊	婊 婊子
伢	伢 伢子
桨	桨 桨叶 桨声 桨片 桨橹 桨板
嗬	嗬 嗬哟
妓	妓 妓女 妓院 妓馆 妓女院 妓女装
瘴	瘴 瘴气 瘴疠 瘴疠之气 瘴雨蛮烟
鹫	鹫 鹫峰 鹫山 鹫峰山
缰	缰 缰绳
眦	眦 眦裂 眦裂发指
隍	隍 隍城
臼	臼 臼齿 臼杵 臼炮 臼杵之交
潦	潦 潦草 潦倒 潦潦草草
魑	魑 魑魅魍魉 魑魅
蹩	蹩 蹩脚 蹩脚货 蹩腳
绢	绢 绢丝 绢画 绢布 绢花 绢子
阡	阡 阡陌 阡表
浔	浔 浔江
犟	犟 犟嘴 犟脾气 犟劲
臆	臆 臆想 臆测 臆造 臆断 臆说
豺	豺 豺狼 豺狼虎豹 豺狗 豺狼成性 豺狼当道
恻	恻 恻隐之心 恻隐 恻然 恻怛之心
嗣	嗣 嗣后 嗣位 嗣宗 嗣子 嗣业
绉	绉 绉纹 绉纱 绉褶 绉布 绉丝
幌	幌 幌子 幌动
蚯	蚯 蚯蚓
沏	沏 沏茶
蹉	蹉 蹉跎 蹉跎岁月 蹉跎光阴 蹉跌 蹉跎时光
拈	拈 拈花 拈花惹草 拈香 拈花微笑 拈须
膺	膺 膺品 膺任 膺选
袒	袒 袒护 袒露 袒胸露乳 袒露出 袒护着
踵	踵 踵事增华 踵至 踵接 踵武 踵武前贤
涸	涸 涸泽而渔 涸辙之鲋
蛐	蛐 蛐蛐 蛐蛐儿
潢	潢 潢川 潢川县
殒	殒 殒命 殒灭 殒落 殒身 殒石
桔	桔 桔子 桔梗 桔梗花 桔黄色 桔子皮
茎	茎 茎杆 茎干 茎秆 茎部
孺	孺 孺子可教 孺子不可 孺子 孺子牛 孺人
悼	悼 悼念 悼词 悼亡 悼文 悼辞
缎	缎 缎带 缎子 缎面 缎被 缎纹
谛	谛 谛听 谛视
菠	菠 菠萝 菠菜 菠萝蜜 菠萝包 菠萝汁
嬷	嬷 嬷嬷
睨	睨 睨视
蛆	蛆 蛆虫
壕	壕 壕沟 壕堑 壕沟战 壕堑战
汲	汲 汲取 汲水 汲汲 汲汲于 汲古阁
堇	堇 堇色 堇菜
偃	偃 偃月 偃旗息鼓 偃师 偃卧 偃武修文
腌	腌 腌制 腌菜 腌臜 腌鱼 腌肉
腌	腌 腌制 腌菜 腌臜 腌鱼 腌肉
颚	颚 颚骨
吮	吮 吮吸 吮痈舐痔 吮乳 吮疽舐痔 吮墨
沭	沭 沭阳 沭河 沭阳县
黍	黍 黍子 黍米 黍离麦秀
旖	旖 旖旎 旖旎风光
酵	酵 酵母菌 酵母 酵素 酵母片 酵解
蕙	蕙 蕙兰 蕙质兰心 蕙心纨质 蕙心兰质 蕙心
燮	燮 燮理 燮理阴阳
炬	炬 炬火
舜	舜 舜天 舜帝 舜尧 舜天队
褒	褒 褒奖 褒义词 褒贬不一 褒义 褒贬
愠	愠 愠怒 愠色 愠容
渤	渤 渤海 渤海湾 渤海海峡 渤海地区
阉	阉 阉割 阉人 阉掉 阉鸡 阉党
倡	倡 倡导 倡议 倡导者 倡议书 倡议者
噘	噘 噘嘴 噘嘴儿
僚	僚 僚机 僚属 僚友 僚佐
倜	倜 倜傥 倜傥不群 倜傥不羁
椭	椭 椭圆形 椭圆 椭圆状 椭圆型 椭球
潞	潞 潞河 潞安 潞城 潞西 潞城县
硫	硫 硫酸 硫磺 硫化氢 硫磺味 硫酸铜
荔	荔 荔枝 荔枝树 荔枝林 荔湾 荔枝汁
膳	膳 膳食 膳房 膳夫 膳费 膳堂
帛	帛 帛书 帛画
睚	睚 睚眦必报 睚眦 睚眦之怨 睚眥
脐	脐 脐带 脐橙 脐部 脐带血
圭	圭 圭亚那 圭臬 圭角 圭亚那政府 圭表
酉	酉 酉时 酉阳 酉长 酉鸡 酉阳县
镐	镐 镐头 镐京 镐素
镐	镐 镐头 镐京 镐素
钒	钒 钒铁
姊	姊 姊妹 姊姊 姊妹篇 姊夫 姊妹花
鞍	鞍 鞍前马后 鞍山 鞍马 鞍子 鞍钢
缔	缔 缔造 缔结 缔造者 缔约 缔交
觊	觊 觊觎
砺	砺 砺石
孵	孵 孵化 孵出 孵蛋 孵小鸡 孵出来
濑	濑 濑户内海 濑户 濑户朝香 濑田
锃	锃 锃亮 锃光瓦亮
瑙	瑙 瑙鲁 瑙曼
梆	梆 梆梆 梆子 梆硬 梆梆响 梆子腔
泫	泫 泫然泪下 泫然欲泪
韭	韭 韭菜 韭黄 韭菜花 韭菜合子 韭芽
泷	泷 泷泽秀明
泷	泷 泷泽秀明
呶	呶 呶呶不休
涤	涤 涤荡 涤卡 涤纶 涤除 涤纶厂
磷	磷 磷火 磷光 磷矿 磷灰石 磷酸
蚱	蚱 蚱蜢 蚱蝉
隽	隽 隽永 隽拔
鳝	鳝 鳝鱼
萃	萃 萃取 萃取液 萃聚
婢	婢 婢女 婢子 婢仆 婢作夫人 婢膝奴颜
幂	幂 幂函数 幂指数
坯	坯 坯子 坯料 坯布 坯胎
唆	唆 唆使
掳	掳 掳走 掳掠 掳获 掳夺
匮	匮 匮乏 匮缺 匮竭
杳	杳 杳无音信 杳无音讯 杳无 杳无人烟 杳无踪影
褴	褴 褴褛 褴褛不堪 褴褛筚路
臧	臧 臧克家 臧否 臧否人物 臧家桥 臧懋循
岌	岌 岌岌可危 岌岌
犁	犁 犁地 犁田 犁头 犁土 犁耙
撰	撰 撰写 撰稿人 撰文 撰稿 撰述
甬	甬 甬道 甬路 甬江 甬剧 甬钟
稷	稷 稷下 稷山 稷山县 稷米
骋	骋 骋目 骋怀
憩	憩 憩息
钛	钛 钛合金 钛酸 钛铁矿 钛白 钛白粉
埔	埔 埔里 埔里镇
埔	埔 埔里 埔里镇
郗	郗 郗恩庭
嘁	嘁 嘁嘁喳喳 嘁嘁嚓嚓
掇	掇 掇菁撷华
烩	烩 烩面 烩饭 烩虾仁
鲫	鲫 鲫鱼 鲫鱼汤
橄	橄 橄榄枝 橄榄 橄榄球 橄榄树 橄榄油
馊	馊 馊主意 馊味 馊水 馊臭 馊水油
蒯	蒯 蒯异度 蒯侍郎 蒯大富
嘹	嘹 嘹亮
桠	桠 桠枫 桠杈 桠枝
鳌	鳌 鳌拜 鳌头 鳌峰 鳌山 鳌头独占
骥	骥 骥骜
缜	缜 缜密 缜密性
揩	揩 揩油 揩去 揩拭 揩泪 揩抹
邙	邙 邙山
垛	垛 垛子 垛口
脓	脓 脓包 脓水 脓血 脓疮 脓液
夯	夯 夯实 夯货 夯土 夯筑 夯土墙
钙	钙 钙片 钙化 钙质 钙奶 钙长石
夯	夯 夯实 夯货 夯土 夯筑 夯土墙
琵	琵 琵琶 琵琶骨 琵琶行 琵琶曲 琵琶别抱
谤	谤 谤议
焊	焊 焊接 焊枪 焊工 焊条 焊成
釜	釜 釜山 釜底抽薪 釜底游鱼 釜底游魂 釜中鱼
孑	孑 孑然一身 孑然 孑孓 孑遗 孑口
枸	枸 枸杞 枸杞子 枸杞茶 枸酱 枸骨
枸	枸 枸杞 枸杞子 枸杞茶 枸酱 枸骨
闽	闽 闽南 闽江 闽南语 闽省 闽北
蘸	蘸 蘸上 蘸湿 蘸笔 蘸火 蘸水笔
瑚	瑚 瑚琏之器
荟	荟 荟萃 荟萃一堂 荟集
碴	碴 碴儿
鄂	鄂 鄂州 鄂伦春 鄂西北 鄂城 鄂尔多斯
遨	遨 遨游 遨游太空 遨游四海 遨游天下
陕	陕 陕西 陕北 陕西省 陕南 陕西人
亥	亥 亥时 亥猪 亥時
殉	殉 殉情 殉职 殉葬 殉国 殉道者
胥	胥 胥吏 胥各庄
硅	硅 硅胶 硅谷 硅化木 硅酸盐 硅酸钙
罂	罂 罂粟 罂粟花 罂粟壳 罂粟科 罂粟碱
谙	谙 谙熟 谙晓 谙练 谙习 谙达
氤	氤 氤氲 氤氳
诋	诋 诋毁
淞	淞 淞沪
涓	涓 涓涓 涓涓细流 涓流 涓滴 涓埃
纾	纾 纾解 纾忧
纣	纣 纣王
摒	摒 摒弃 摒除 摒弃前嫌 摒出 摒挡
隘	隘 隘口 隘路 隘险 隘巷
鸷	鸷 鸷鸟 鸷鹰
巽	巽 巽他群岛 巽他
逯	逯 逯钦立
捍	捍 捍卫 捍卫者 捍御 捍拒 捍卫战士
哺	哺 哺育 哺乳动物 哺乳 哺乳期 哺乳类
荏	荏 荏苒 荏弱 荏平
簪	簪 簪子 簪缨 簪花 簪缨世族
旮	旮 旮旯 旮旯儿 旮旮旯旯
佚	佚 佚名 佚事 佚文 佚失
祛	祛 祛除 祛病 祛斑 祛风 祛瘀
篡	篡 篡改 篡位 篡夺 篡权 篡党夺权
拮	拮 拮据 拮抗剂 拮抗
叁	叁 叁天
苯	苯 苯胺 苯教 苯丙氨酸 苯环 苯丙
恽	恽 恽代英 恽寿平
绛	绛 绛红色 绛色 绛紫色 绛紫 绛州
铝	铝 铝合金 铝锅 铝制 铝盆 铝业
毡	毡 毡帽 毡子 毡靴 毡房 毡毯
茁	茁 茁壮成长 茁壮 茁长 茁实
艮	艮 艮岳
徙	徙 徙步 徙居 徙倚 徙边
掬	掬 掬水 掬诚
侨	侨 侨民 侨胞 侨乡 侨联 侨情
谕	谕 谕旨 谕令 谕示 谕知 谕告
呓	呓 呓语
畸	畸 畸形 畸变 畸形儿 畸形发展 畸型
姹	姹 姹紫嫣红 姹紫焉红
蓁	蓁 蓁蓁
酩	酩 酩酊大醉 酩酊 酩酊烂醉
蜚	蜚 蜚语 蜚声 蜚短流长 蜚声中外 蜚廉
赝	赝 赝品 赝鼎 赝本
酋	酋 酋长 酋长国 酋長
谆	谆 谆谆教导 谆谆教诲 谆谆 谆谆告诫 谆谆嘱咐
砾	砾 砾石 砾岩 砾漠 砾土
笆	笆 笆篱 笆斗 笆篓
箩	箩 箩筐 箩卜 箩北县
迥	迥 迥异 迥然不同 迥然 迥乎不同 迥然相异
骡	骡 骡子 骡马 骡车 骡夫 骡驮子
麾	麾 麾下 麾军
镂	镂 镂空 镂刻 镂空雕 镂花 镂骨铭心
洱	洱 洱海 洱源县 洱源
宕	宕 宕机 宕昌县
嗫	嗫 嗫嚅 嗫嗫嚅嚅
竣	竣 竣工 竣事
槌	槌 槌子 槌棒
黔	黔 黔驴技穷 黔县 黔江 黔南 黔阳
膘	膘 膘肥体壮 膘肥体胖 膘情 膘肥肉厚
蹶	蹶 蹶子
纰	纰 纰漏 纰缪
焖	焖 焖饭 焖牛肉
狒	狒 狒狒
嚅	嚅 嚅嚅
剽	剽 剽窃 剽悍 剽窃者 剽掠 剽袭
邯	邯 邯郸 邯郸学步 邯钢 邯鄲學步 邯郸市
筏	筏 筏子 筏头 筏基
嗳	嗳 嗳呀 嗳气
埂	埂 埂子
堑	堑 堑壕 堑山堙谷 堑壕战
荨	荨 荨麻疹 荨麻
鎏	鎏 鎏金
聒	聒 聒噪 聒耳 聒不知耻
茴	茴 茴香 茴香豆 茴香油
栉	栉 栉风沐雨 栉比 栉比鳞次 栉沐
虱	虱 虱子 虱多不痒 虱目 虱目鱼
蛀	蛀 蛀虫 蛀牙 蛀蚀 蛀洞 蛀坏
迄	迄 迄今为止 迄今 迄今已有 迄今已 迄未
偕	偕 偕老 偕同 偕行
虬	虬 虬龙 虬髯 虬须 虬枝
泗	泗 泗水 泗州 泗洲 泗洪 泗州城
忤	忤 忤逆 忤逆不孝 忤违
雎	雎 雎鸠
阖	阖 阖家欢乐 阖家幸福 阖上 阖家 阖眼
糜	糜 糜烂 糜烂不堪 糜子 糜费 糜夫人
钗	钗 钗头凤 钗横鬓乱
逄	逄 逄先知
贰	贰 贰仟 贰心 贰臣
赳	赳 赳赳 赳赳武夫
剜	剜 剜肉补疮 剜除
麋	麋 麋鹿 麋羚
霁	霁 霁月 霁月光风 霁色
睥	睥 睥睨 睥睨一切 睥睨群雄
嫔	嫔 嫔妃 嫔从
睢	睢 睢宁 睢县 睢宁县
缨	缨 缨子 缨络 缨帽 缨穗 缨冠
渭	渭 渭河 渭水 渭南 渭北 渭城
忻	忻 忻州 忻口 忻城伯 忻城县 忻州市
谀	谀 谀词 谀辞
孱	孱 孱弱 孱头 孱弱无力
杞	杞 杞人忧天 杞县 杞人之忧 杞国 杞天之虑
孱	孱 孱弱 孱头 孱弱无力
潸	潸 潸然泪下 潸然 潸潸 潸然淚下
侏	侏 侏儒 侏罗纪 侏儒症 侏罗系 侏罗世
湍	湍 湍急 湍流
砣	砣 砣子
呤	呤 呤呤
沂	沂 沂蒙 沂河 沂源 沂蒙山 沂水
榔	榔 榔头 榔榆 榔頭
糠	糠 糠麸 糠皮 糠菜 糠虾 糠秕
噱	噱 噱头
噱	噱 噱头
犄	犄 犄角 犄角之势
挛	挛 挛生 挛缩
澹	澹 澹台 澹台小姐 澹台勉 澹台玮
氢	氢 氢气 氢气球 氢弹 氢氧化钠 氢原子
襁	襁 襁褓 襁褓之中
澹	澹 澹台 澹台小姐 澹台勉 澹台玮
擀	擀 擀面杖 擀毡 擀杖 擀面仗
轱	轱 轱辘 轱轳
竺	竺 竺可桢 竺法护 竺叔兰
皖	皖 皖南 皖北 皖江 皖西 皖南事变
莠	莠 莠民
碉	碉 碉堡 碉楼 碉群
痉	痉 痉挛 痉挛性
贲	贲 贲门 贲临 贲任 贲士 贲门癌
赁	赁 赁租
潋	潋 潋滟
涔	涔 涔涔
荻	荻 荻村伊智朗
颌	颌 颌骨 颌面 颌下腺 颌面部
鸵	鸵 鸵鸟 鸵鸟蛋 鸵鸟政策
鼬	鼬 鼬鼠 鼬獾
峪	峪 峪口
樵	樵 樵夫 樵采 樵子
颌	颌 颌骨 颌面 颌下腺 颌面部
踊	踊 踊跃 踊跃报名 踊跃发言 踊跃输将
濮	濮 濮阳 濮存昕 濮之战 濮州 濮阳县
陇	陇 陇西 陇南 陇山 陇东 陇上
蚌	蚌 蚌壳 蚌埠 蚌珠 蚌类 蚌埠市
噻	噻 噻吩 噻嗪 噻唑
驮	驮 驮背 驮负 驮子 驮运 驮马
泾	泾 泾渭分明 泾源 泾河 泾阳 泾渭
驮	驮 驮背 驮负 驮子 驮运 驮马
氮	氮 氮气 氮肥厂 氮肥 氮磷 氮素
瘠	瘠 瘠薄 瘠瘦 瘠义肥辞
儆	儆 儆戒
彗	彗 彗星 彗尾 彗发 彗核
札	札 札记 札幌 札幌市 札木合 札实
釉	釉 釉里红 釉色 釉面 釉瓷 釉子
蔻	蔻 蔻丹
遑	遑 遑论 遑遑不可 遑論 遑论其他
讼	讼 讼师 讼词 讼棍 讼事 讼案
殄	殄 殄灭
炀	炀 炀帝
娉	娉 娉婷 娉娉婷婷 娉婷袅娜 娉婷婀娜
羌	羌 羌族 羌塘 羌笛 羌活 羌寨
蝈	蝈 蝈蝈 蝈蝈儿
诏	诏 诏书 诏令 诏告 诏命 诏安
咝	咝 咝咝 咝咝声 咝儿
黢	黢 黢黑
刈	刈 刈草 刈稻 刈除
垦	垦 垦荒地 垦地 垦荒 垦殖 垦区
庵	庵 庵堂 庵主 庵寺 庵儿
囤	囤 囤积 囤货 囤积居奇 囤粮 囤积者
囤	囤 囤积 囤货 囤积居奇 囤粮 囤积者
舷	舷 舷窗 舷梯 舷外 舷侧 舷墙
醍	醍 醍醐灌顶 醍醐
蝗	蝗 蝗虫 蝗灾 蝗灭 蝗蝻 蝗害
桎	桎 桎梏
铂	铂 铂金 铂金卡 铂金版
娼	娼 娼妓 娼妇 娼盛 娼妓馆
颉	颉 颉颃
瘀	瘀 瘀伤 瘀血 瘀斑 瘀泥 瘀积
颉	颉 颉颃
恁	恁 恁地 恁般
饽	饽 饽饽
诨	诨 诨名 诨号
孪	孪 孪生 孪生兄弟 孪生姐妹 孪生子 孪生儿
锭	锭 锭子
赊	赊 赊账 赊欠 赊给 赊帐 赊债
缄	缄 缄默 缄口不言 缄口 缄口不语 缄默无语
箬	箬 箬笠 箬帽 箬竹
尕	尕 尕斯库勒 尕玛 尕海
珲	珲 珲春 珲春市
铤	铤 铤而走险
沽	沽 沽名钓誉 沽酒 沽名 沽源 沽名钩誉
龅	龅 龅牙
扪	扪 扪心自问 扪心 扪参历井 扪住 扪心自省
鲛	鲛 鲛绡
茯	茯 茯苓 茯神 茯苓皮
肱	肱 肱骨 肱股
冗	冗 冗长 冗杂 冗余 冗繁 冗员
诃	诃 诃德 诃子
濯	濯 濯濯 濯足 濯锦 濯缨 濯身
倨	倨 倨傲 倨傲不恭
怆	怆 怆然泪下 怆然涕下 怆地呼天
恣	恣 恣意 恣肆 恣意妄为 恣情 恣睢
赧	赧 赧然 赧颜 赧愧 赧颜汗下
魍	魍 魍魉 魍魎
钠	钠 钠灯 钠离子 钠长石 钠盐 钠硫电池
悖	悖 悖论 悖逆 悖谬 悖乱 悖晦
沱	沱 沱江 沱沱河 沱牌 沱茶 沱湖
肛	肛 肛门 肛裂 肛肠 肛肠科 肛瘘
桧	桧 桧木 桧柏
桧	桧 桧木 桧柏
茱	茱 茱莉亚 茱萸 茱丽叶
跛	跛 跛子 跛脚 跛足 跛行 跛行症
蝌	蝌 蝌蚪 蝌蚪文
淆	淆 淆乱 淆惑 淆乱视听 淆杂
锌	锌 锌皮 锌矿 锌锭 锌版 锌肥
轧	轧 轧死 轧钢厂 轧断 轧马路 轧机
轧	轧 轧死 轧钢厂 轧断 轧马路 轧机
轧	轧 轧死 轧钢厂 轧断 轧马路 轧机
驷	驷 驷马难追 驷马 驷马高盖 驷不及舌 驷马高车
隗	隗 隗瀛涛
酗	酗 酗酒 酗酒滋事 酗酒闹事
齑	齑 齑粉
羸	羸 羸弱 羸疾 羸瘦
刽	刽 刽子手
俎	俎 俎上肉 俎上之肉
隗	隗 隗瀛涛
晁	晁 晁错 晁补之 晁盖宋 晁天王 晁盖便
宦	宦 宦官 宦之家 宦海沉浮 宦海 宦者
帧	帧 帧定位 帧频 帧内压缩
摹	摹 摹仿 摹本 摹拟 摹写 摹刻
蛹	蛹 蛹期
箕	箕 箕门 箕帚 箕裘 箕宿 箕斗
颧	颧 颧骨
萘	萘 萘酚
崆	崆 崆峒 崆峒山
徜	徜 徜徉 徜徉于
囫	囫 囫囵 囫囵吞枣 囫囵半片
獐	獐 獐头鼠目 獐子
罔	罔 罔顾 罔替 罔极 罔效 罔极之恩
壬	壬 壬戌 壬申 壬辰 壬午年 壬午
巳	巳 巳时 巳蛇 巳時
驿	驿 驿站 驿馆 驿道 驿路 驿马
痨	痨 痨病
蒿	蒿 蒿草 蒿子 蒿子秆 蒿杆 蒿本
蛭	蛭 蛭石
磬	磬 磬竹难书
椿	椿 椿树 椿萱 椿皮
酊	酊 酊剂
铄	铄 铄石流金 铄金
睑	睑 睑缘炎 睑下垂
鹑	鹑 鹑衣百结 鹑衣 鹑居
乜	乜 乜斜 乜嘢 乜乜斜斜
乜	乜 乜斜 乜嘢 乜乜斜斜
跻	跻 跻身 跻身于
锲	锲 锲而不舍
蕤	蕤 蕤宾 蕤仁
抨	抨 抨击 抨弹 抨擊
蜃	蜃 蜃楼 蜃景 蜃气 蜃楼海市
孚	孚 孚日 孚众望 孚尹旁达 孚日山
镌	镌 镌刻 镌印 镌镂 镌心铭骨 镌琢
笺	笺 笺纸 笺注 笺言 笺谱
搽	搽 搽着 搽药 搽脂抹粉 搽粉
怄	怄 怄气
葶	葶 葶苈子
毗	毗 毗邻 毗连 毗湿奴 毗连区 毗卢寺
豌	豌 豌豆 豌豆荚 豌豆苗 豌豆粉 豌豆黄
俾	俾 俾斯麦 俾昼作夜 俾能 俾路支省 俾斯麦群岛
泵	泵 泵房 泵车 泵站 泵入 泵送
鹌	鹌 鹌鹑 鹌鹑蛋
撺	撺 撺掇 撺弄
滇	滇 滇南 滇西 滇红 滇池 滇西南
圩	圩 圩镇 圩堤 圩场 圩田 圩子
藩	藩 藩王 藩篱 藩国 藩镇 藩属国
圩	圩 圩镇 圩堤 圩场 圩田 圩子
恹	恹 恹恹
鬣	鬣 鬣狗 鬣鬃 鬣蜥
砧	砧 砧板 砧木 砧子 砧杵
郴	郴 郴县 郴州 郴州市
滂	滂 滂沱 滂沱大雨 滂湃 滂沛
鳗	鳗 鳗鱼 鳗鲡
楔	楔 楔子 楔形 楔形文字 楔入 楔住
樯	樯 樯橹 樯倾楫摧
荃	荃 荃湾 荃灣
湄	湄 湄公河 湄南河 湄潭 湄州 湄洲湾
蝮	蝮 蝮蛇 蝮蛇螫手
匝	匝 匝道 匝地 匝月
榛	榛 榛子 榛蘑 榛莽 榛树 榛林
忸	忸 忸怩 忸怩不安 忸怩作态
旌	旌 旌旗 旌阳 旌旗招展 旌德 旌旗蔽空
诙	诙 诙谐 诙谐地 诙谐曲
灞	灞 灞河 灞桥 灞陵 灞桥区
锚	锚 锚链 锚地 锚缆 锚固 锚杆
挞	挞 挞伐
馥	馥 馥郁
鄢	鄢 鄢烈山 鄢陵 鄢陵之战 鄢陵县 鄢陵君
貔	貔 貔貅 貔虎
迩	迩 迩来
胫	胫 胫骨
蠡	蠡 蠡园 蠡县 蠡测 蠡沟
塾	塾 塾师
哂	哂 哂笑 哂然 哂纳
喙	喙 喙长三尺
邈	邈 邈远 邈视 邈然
薏	薏 薏米 薏苡 薏仁 薏苡仁 薏仁粉
胛	胛 胛骨
碱	碱 碱性 碱面 碱基 碱液 碱厂
敕	敕 敕令 敕封 敕勒川 敕命 敕书
邝	邝 邝曰广
羯	羯 羯鼓 羯羊
伥	伥 伥鬼
霭	霭 霭霭
浚	浚 浚县
腱	腱 腱子 腱鞘炎 腱鞘
浚	浚 浚县
螯	螯 螯合物 螯合剂 螯合
戍	戍 戍边 戍守 戍卫 戍卒 戍守边疆
苌	苌 苌弘化碧
氨	氨 氨基酸 氨气 氨基 氨水 氨苄
皴	皴 皴裂 皴法 皴擦
裱	裱 裱糊 裱画 裱褙 裱工 裱贴
矍	矍 矍铄
袈	袈 袈裟
獾	獾 獾油 獾猪
枳	枳 枳实 枳壳
鹄	鹄 鹄立 鹄形鸠面 鹄面鸠形
鹄	鹄 鹄立 鹄形鸠面 鹄面鸠形
镣	镣 镣铐
赡	赡 赡养 赡养费 赡养父母 赡养人
癸	癸 癸丑 癸巳 癸酉 癸卯 癸未
雹	雹 雹子 雹灾 雹霰 雹暴
耘	耘 耘田 耘锄 耘草 耘地
叵	叵 叵测 叵耐 叵测之心
酪	酪 酪浆 酪氨酸 酪饼 酪农场 酪酸
缮	缮 缮写 缮修 缮写员
秆	秆 秆子
蔗	蔗 蔗糖 蔗田 蔗园 蔗渣 蔗农
綦	綦 綦江 綦母怀 綦江县 綦毋怀
蛔	蛔 蛔虫 蛔厥 蛔虫病
脍	脍 脍炙人口 脍炙 脍不厌细
藓	藓 藓苔 藓类
仄	仄 仄仄 仄声 仄韵
鸩	鸩 鸩毒 鸩酒
溥	溥 溥仪 溥仪之 溥仪先
闰	闰 闰年 闰月 闰日 闰秒
桁	桁 桁架 桁梁
镁	镁 镁光灯 镁光 镁粉 镁矿 镁砂
蕨	蕨 蕨菜 蕨类植物 蕨类
痔	痔 痔疮 痔漏 痔疮膏
戌	戌 戌时 戌狗
骊	骊 骊山 骊歌 骊珠 骊驹
赣	赣 赣州 赣南 赣江 赣州市 赣西
敝	敝 敝帚自珍 敝履 敝姓 敝屣 敝舍
猕	猕 猕猴 猕猴桃
恸	恸 恸哭
蝰	蝰 蝰蛇
砝	砝 砝码
泸	泸 泸州 泸沽湖 泸定桥 泸水 泸定
莳	莳 莳萝 莳秧 莳花种草
蚤	蚤 蚤休
樽	樽 樽俎 樽前月下
耒	耒 耒耜 耒阳 耒阳市
觥	觥 觥筹交错 觥筹
膻	膻 膻中 膻味 膻气
娩	娩 娩出
鼋	鼋 鼋头渚 鼋鱼 鼋鸣鳖应
胴	胴 胴体
蹴	蹴 蹴鞠
谪	谪 谪仙 谪居 谪降 谪戍 谪迁
阪	阪 阪神 阪田 阪崎
谏	谏 谏言 谏议 谏官 谏诤 谏院
徇	徇 徇私 徇私枉法 徇私舞弊 徇私情 徇情
骐	骐 骐骥 骐骥过隙
膈	膈 膈膜 膈关
弭	弭 弭兵之会
匈	匈 匈奴 匈牙利 匈牙利人 匈奴血 匈牙利语
笤	笤 笤帚
堰	堰 堰塞湖 堰口 堰桥
郸	郸 郸城 郸城县
煅	煅 煅烧
蜇	蜇 蜇伤
鬃	鬃 鬃毛 鬃刷
饷	饷 饷银 饷客
遒	遒 遒劲 遒健 遒勁
舐	舐 舐犊情深 舐食 舐吃 舐犊之爱 舐糠及米
槁	槁 槁木 槁木死灰
舛	舛 舛错 舛误 舛驳 舛谬 舛杂
诓	诓 诓骗
纫	纫 纫针
胱	胱 胱氨酸 胱胺酸
镊	镊 镊子
荜	荜 荜澄茄 荜路蓝缕
诟	诟 诟病 诟骂
沣	沣 沣河
罄	罄 罄竹难书 罄尽 罄笔难书 罄竭 罄其所有
糅	糅 糅合 糅杂
銮	銮 銮驾 銮舆 銮铃
歙	歙 歙砚 歙县 歙縣
歙	歙 歙砚 歙县 歙縣
邕	邕 邕城 邕江 邕宁 邕剧
秸	秸 秸秆 秸杆
缱	缱 缱绻
蟋	蟋 蟋蟀 蟋蟀草
嗟	嗟 嗟来之食 嗟叹 嗟悔 嗟悔无及 嗟来食
贮	贮 贮存 贮藏 贮备 贮满 贮量
鹞	鹞 鹞子 鹞子翻身 鹞鹰 鹞式
髯	髯 髯口
刎	刎 刎颈之交
柑	柑 柑橘 柑子 柑桔 柑皮 柑果
晤	晤 晤面 晤对 晤谈 晤见 晤商
烯	烯 烯酮 烯丙基 烯类 烯醇 烯酸
筵	筵 筵席 筵宴 筵上 筵会 筵席捐
熨	熨 熨斗 熨帖 熨烫 熨平 熨熨贴贴
涝	涝 涝灾 涝池 涝情 涝坝 涝地
逡	逡 逡巡 逡巡不前
雉	雉 雉鸡 雉尾 雉堞 雉鸠
珐	珐 珐琅 珐琅质 珐瑯
贻	贻 贻笑大方 贻误 贻害 贻笑 贻误战机
钎	钎 钎子 钎头 钎焊
皈	皈 皈依
瘙	瘙 瘙痒 瘙痒症
诳	诳 诳语 诳骗 诳话 诳时惑众 诳言
猞	猞 猞猁
湟	湟 湟中县 湟鱼 湟源 湟水 湟源县
汾	汾 汾酒 汾河 汾水 汾阳 汾西
痢	痢 痢疾 痢特灵 痢疾杆菌
阆	阆 阆苑 阆中 阆中县 阆中市
矬	矬 矬子
疹	疹 疹子 疹块
翕	翕 翕动 翕张 翕然 翕如
谲	谲 谲而不正
姘	姘 姘头 姘居 姘妇 姘夫
镭	镭 镭射 镭射光 镭射气
牯	牯 牯岭 牯牛
蟊	蟊 蟊贼
侗	侗 侗族 侗寨 侗乡
杷	杷 杷子
侗	侗 侗族 侗寨 侗乡
舶	舶 舶来品 舶来货 舶來品
誊	誊 誊写 誊抄 誊清 誊录 誊印社
铡	铡 铡刀 铡草
幔	幔 幔帐 幔子
谚	谚 谚语
盂	盂 盂兰盆会 盂县
碘	碘 碘酒 碘钨灯 碘酊 碘盐 碘片
鹧	鹧 鹧鸪天 鹧鸪 鹧鸪菜
唢	唢 唢呐 唢呐声
戊	戊 戊辰 戊戌变法 戊寅 戊午 戊子
亟	亟 亟需 亟待 亟待解决 亟须 亟盼
汴	汴 汴京 汴梁 汴州 汴河
汛	汛 汛期 汛情
爻	爻 爻辞 爻象
阄	阄 阄割
亟	亟 亟需 亟待 亟待解决 亟须 亟盼
颀	颀 颀长 颀然
岿	岿 岿然不动 岿然 岿然独存
掮	掮 掮客
鸪	鸪 鸪鸪
酮	酮 酮体 酮类 酮康唑 酮酸 酮症
饯	饯 饯行 饯别 饯送
翦	翦 翦伯赞
氯	氯 氯化钠 氯化氢 氯化钙 氯化钾 氯化铵
胺	胺 胺类 胺基酸 胺基 胺盐 胺多酚
绥	绥 绥靖 绥远 绥化 绥德 绥东
鳕	鳕 鳕鱼
廿	廿 廿四 廿年 廿八 廿二 廿九
埠	埠 埠头
趿	趿 趿拉 趿着
厩	厩 厩肥
嵇	嵇 嵇中散 嵇中散集 嵇康集
莅	莅 莅临 莅临指导 莅会
淙	淙 淙淙 淙淙流水
砥	砥 砥柱 砥砺 砥柱中流 砥石 砥砺名节
毽	毽 毽子
谗	谗 谗言 谗猫 谗佞 谗嘴 谗鬼
枇	枇 枇杷 枇杷树 枇杷膏 枇杷叶 枇杷门巷
瓤	瓤 瓤子
淄	淄 淄博 淄川 淄博市 淄川区
迤	迤 迤逦
刍	刍 刍狗 刍议 刍荛 刍荛之见 刍言
荞	荞 荞麦 荞麦皮 荞麦面 荞麦壳 荞麦米
瘌	瘌 瘌痢 瘌痢头
衮	衮 衮州 衮衮 衮衮诸公
霰	霰 霰弹枪 霰弹
铀	铀 铀矿
鲈	鲈 鲈鱼
苜	苜 苜蓿 苜蓿草
狍	狍 狍子
酶	酶 酶系统 酶类 酶法 酶原 酶制剂
铆	铆 铆钉 铆劲 铆工 铆劲儿 铆接
唁	唁 唁电 唁函
庖	庖 庖厨 庖丁解牛 庖丁 庖代
鲑	鲑 鲑鱼
佤	佤 佤族
悱	悱 悱恻 悱恻缠绵
诘	诘 诘问 诘难 诘责 诘屈聱牙 诘曲聱牙
茕	茕 茕茕孑立
鲢	鲢 鲢鱼
纂	纂 纂修 纂辑 纂夺
璎	璎 璎珞
攫	攫 攫取 攫住 攫取财富 攫为己有 攫去
暨	暨 暨大 暨南大学 暨南 暨世界 暨首届
遽	遽 遽然 遽尔 遽下 遽下结论
蒽	蒽 蒽醌 蒽环类
铧	铧 铧犁
盥	盥 盥洗室 盥洗 盥洗间 盥洗台 盥漱
喟	喟 喟叹 喟然 喟然长叹 喟然而叹
萼	萼 萼片
阜	阜 阜阳 阜城 阜新 阜成门 阜平县
汨	汨 汨罗 汨罗江 汨罗市
苕	苕 苕帚 苕子
耆	耆 耆那教 耆宿 耆老 耆儒
崂	崂 崂山 崂山区
苕	苕 苕帚 苕子
鏖	鏖 鏖战 鏖兵 鏖战犹酣 鏖战到底
莆	莆 莆田 莆田县 莆田人 莆田市 莆仙戏
茏	茏 茏葱
靛	靛 靛蓝色 靛蓝 靛青 靛紫
掴	掴 掴耳光
驸	驸 驸马 驸马爷
踟	踟 踟蹰 踟蹰不前 踟躇 踟躇不前 踟蹰不进
芡	芡 芡粉 芡实
锒	锒 锒铛入狱 锒铛
罹	罹 罹难 罹患 罹灾 罹祸 罹难者
傣	傣 傣族 傣家 傣历 傣味 傣乡
皋	皋 皋兰 皋兰县 皋兰山 皋落
猢	猢 猢狲
涑	涑 涑水
蠹	蠹 蠹虫 蠹鱼 蠹简 蠹国害民
勐	勐 勐海县 勐腊 勐海 勐仑 勐腊县
癣	癣 癣疥 癣疥之疾
喑	喑 喑哑
豇	豇 豇豆
雒	雒 雒于仁
郦	郦 郦道元 郦食其 郦寄攻 郦寄击
焙	焙 焙烧 焙茶 焙干 焙烤 焙制
哓	哓 哓哓 哓哓不休
洮	洮 洮河 洮砚 洮南 洮州 洮儿河
豢	豢 豢养
觐	觐 觐见 觐谒 觐礼
芍	芍 芍药 芍药花 芍陂 芍药居
媾	媾 媾和 媾合
桅	桅 桅杆 桅灯 桅樯 桅帆 桅楼
楦	楦 楦子 楦头
郢	郢 郢州 郢书燕说
蓟	蓟 蓟州 蓟城 蓟县 蓟门 蓟北
麝	麝 麝香 麝鼠 麝香鹿 麝牛 麝香草
箴	箴 箴言 箴规
燧	燧 燧石 燧人氏 燧道
颍	颍 颍川 颍河 颍阳 颍上县 颍泉区
楹	楹 楹联
楸	楸 楸子 楸树
葳	葳 葳蕤
箔	箔 箔条 箔片
煸	煸 煸炒 煸动
撷	撷 撷取 撷拾
俸	俸 俸禄 俸给 俸钱
彝	彝 彝族 彝人 彝山 彝语 彝良
蓼	蓼 蓼花 蓼藍 蓼蓝
糍	糍 糍粑
鞑	鞑 鞑子 鞑虏 鞑靼 鞑靼人 鞑靼斯坦
苁	苁 苁蓉
辊	辊 辊子 辊轴
孢	孢 孢子 孢粉 孢子粉 孢子囊 孢子植物
蕃	蕃 蕃茄 蕃薯 蕃息 蕃客 蕃庶
瓯	瓯 瓯越 瓯海 瓯江 瓯绣 瓯海区
铩	铩 铩羽而归 铩羽 铩羽暴鳞
汞	汞 汞液 汞合金 汞柱 汞化物
貉	貉 貉子 貉绒
铢	铢 铢两 铢积寸累 铢两悉称
稗	稗 稗子 稗官野史 稗史 稗官小说 稗官
麸	麸 麸皮 麸子
黟	黟 黟县
踽	踽 踽踽独行 踽踽 踽踽而行 踽踽凉凉
闾	闾 闾里 闾巷 闾阎 闾弟夫 闾伐楚
蛎	蛎 蛎黄
闩	闩 闩门闭户
潍	潍 潍坊 潍坊市 潍县 潍河 潍城区
佃	佃 佃户 佃农 佃客 佃租 佃权
佃	佃 佃户 佃农 佃客 佃租 佃权
闳	闳 闳大不经
擘	擘 擘肌分理 擘画
蜉	蜉 蜉蝣
棣	棣 棣棠
鲠	鲠 鲠直
祢	祢 祢衡
氙	氙 氙气 氙气灯 氙灯
玳	玳 玳瑁 玳玳花
镔	镔 镔铁
罅	罅 罅隙 罅口 罅漏
蚝	蚝 蚝油
徵	徵 徵兆 徵求 徵召 徵收 徵解
捭	捭 捭阖
倥	倥 倥偬
邰	邰 邰正宵 邰丽华
偈	偈 偈语
荚	荚 荚果 荚膜 荚膜多糖
渥	渥 渥太华 渥丹 渥堆 渥太华市
龈	龈 龈交 龈齿弹舌 龈成形术 龈切除术 龈上牙石
耄	耄 耄耋 耄耋之年
跗	跗 跗骨 跗蹠 跗阳
饴	饴 饴糖
龈	龈 龈交 龈齿弹舌 龈成形术 龈切除术 龈上牙石
犍	犍 犍为 犍为县 犍牛
笞	笞 笞击 笞杖 笞责
犍	犍 犍为 犍为县 犍牛
篙	篙 篙子 篙头
熵	熵 熵增加
嗥	嗥 嗥叫
寤	寤 寤寐 寤寐求之
裨	裨 裨益 裨将 裨助
牦	牦 牦牛 牦牛肉
庾	庾 庾澄庆 庾信 庾子山 庾开府 庾太后
裨	裨 裨益 裨将 裨助
砒	砒 砒霜 砒石
衢	衢 衢州 衢县 衢巷 衢道 衢州市
铬	铬 铬铁 铬钢 铬铁矿 铬黄 铬钼
涿	涿 涿鹿 涿县 涿州 涿州市 涿鹿县
钾	钾 钾盐 钾钠 钾长石 钾肥 钾矿
俚	俚 俚语 俚言 俚俗 俚曲 俚歌
桉	桉 桉树 桉树林 桉油
鳜	鳜 鳜鱼
瓠	瓠 瓠子
钨	钨 钨丝灯 钨丝 钨钢 钨铁 钨矿
麂	麂 麂子 麂皮
讴	讴 讴歌 讴吟 讴功颂德
粲	粲 粲然一笑 粲然 粲然可观
苫	苫 苫布 苫盖 苫子
甑	甑 甑子
洄	洄 洄游
醛	醛 醛酸 醛类 醛固酮
藜	藜 藜芦
玎	玎 玎玎玲玲
恫	恫 恫吓 恫瘝 恫喝
掼	掼 掼纱帽
柘	柘 柘城 柘城县 柘林 柘荣
鳃	鳃 鳃裂 鳃裂囊肿
睾	睾 睾丸 睾酮 睾丸酮 睾丸癌 睾丸素
鲟	鲟 鲟鱼
谒	谒 谒见 谒拜 谒陵 谒祖
兖	兖 兖州 兖州煤业 兖矿
漕	漕 漕运 漕粮 漕河 漕溪 漕河泾
鹘	鹘 鹘入鸦群
鹘	鹘 鹘入鸦群
镍	镍 镍币 镍都 镍铁 镍合金 镍铬
蓑	蓑 蓑衣 蓑笠 蓑草 蓑衣草
卅	卅 卅年 卅三 卅一日 卅日
莨	莨 莨菪 莨绸
腓	腓 腓特烈 腓肠肌 腓力二世 腓尼基 腓骨
垭	垭 垭口
鸨	鸨 鸨母 鸨婆 鸨儿
痱	痱 痱子 痱子粉 痱粉
犰	犰 犰狳
囹	囹 囹圄
涞	涞 涞源 涞水 涞源县 涞水县
岫	岫 岫岩 岫云 岫岩县
忝	忝 忝不知耻
凫	凫 凫水 凫趋雀跃
郾	郾 郾城
鹬	鹬 鹬蚌相争 鹬蚌相持 鹬类 鹬鸵
谶	谶 谶语 谶纬 谶言 谶书
氰	氰 氰化 氰化钾 氰化物 氰酸 氰化氢
缛	缛 缛节
怛	怛 怛然失色
钕	钕 钕铁硼
荠	荠 荠菜 荠荠菜
荠	荠 荠菜 荠荠菜
浜	浜 浜松
殁	殁 殁世不忘
谯	谯 谯楼 谯城区
馏	馏 馏程 馏出物 馏分油 馏分
腭	腭 腭裂
鳏	鳏 鳏夫 鳏寡孤独 鳏居 鳏寡 鳏鱼渴凤
侉	侉 侉子
绦	绦 绦子 绦虫
胰	胰 胰岛素 胰腺癌 胰子 胰岛素瘤 胰腺炎
钜	钜 钜子 钜额
妊	妊 妊娠 妊娠期 妊妇 妊孕
锉	锉 锉刀 锉子 锉成 锉尖 锉去
磴	磴 磴道 磴口县 磴口
墒	墒 墒情
艄	艄 艄公
镗	镗 镗孔 镗床
鼹	鼹 鼹鼠
皲	皲 皲裂
辔	辔 辔头
蹼	蹼 蹼趾
缌	缌 缌麻服
鼯	鼯 鼯鼠
狻	狻 狻猊
佞	佞 佞臣 佞笑 佞人 佞佛
毂	毂 毂辘 毂击肩摩
窠	窠 窠臼 窠巢 窠穴
吡	吡 吡啶 吡哆醇 吡哌酸 吡哆醛 吡咯
亳	亳 亳州 亳县 亳州市
荥	荥 荥阳 荥经 荥阳县 荥经县 荥阳市
癔	癔 癔症 癔病
圜	圜 圜丘
荥	荥 荥阳 荥经 荥阳县 荥经县 荥阳市
碣	碣 碣石
圜	圜 圜丘
沆	沆 沆瀣一气 沆瀣
妯	妯 妯娌
钿	钿 钿合金钗
菟	菟 菟丝子
肄	肄 肄业 肄业生 肄习
澶	澶 澶渊
菖	菖 菖蒲
钿	钿 钿合金钗
泔	泔 泔水 泔水桶
砷	砷 砷中毒 砷化物 砷化镓
赈	赈 赈灾 赈济 赈饥 赈粮 赈款
颛	颛 颛顼 颛臾
痦	痦 痦子
狴	狴 狴犴
椽	椽 椽子
趵	趵 趵突泉 趵突
莒	莒 莒城 莒南 莒县 莒南县 莒光日
鄱	鄱 鄱阳湖 鄱阳 鄱阳湖畔 鄱阳湖区 鄱阳县
歃	歃 歃血为盟 歃血 歃血结盟
隳	隳 隳肝沥胆
斡	斡 斡旋 斡旋到底
婺	婺 婺源 婺州 婺源县 婺绿 婺城区
陂	陂 陂塘 陂陀 陂池
窨	窨 窨井盖 窨井
獬	獬 獬豸
苋	苋 苋菜 苋科
氟	氟 氟利昂 氟化氢 氟哌酸 氟里昂 氟化
窨	窨 窨井盖 窨井
蝤	蝤 蝤蛑
洇	洇 洇湿
迳	迳 迳自 迳直
豉	豉 豉汁
陂	陂 陂塘 陂陀 陂池
蚍	蚍 蚍蜉撼树 蚍蜉 蚍蜉撼大树
蝤	蝤 蝤蛑
枞	枞 枞树 枞阳 枞木 枞阳县
砀	砀 砀山 砀山县
钴	钴 钴蓝 钴蓝色
枞	枞 枞树 枞阳 枞木 枞阳县
邗	邗 邗沟 邗江 邗江区
箜	箜 箜篌
钡	钡 钡餐 钡剂
螟	螟 螟蛉 螟岭 螟虫 螟蛾
蹁	蹁 蹁跹
蛴	蛴 蛴螬
锂	锂 锂电池 锂离子 锂电 锂辉石
殚	殚 殚精竭虑 殚精竭力 殚心 殚心竭力 殚思竭虑
谥	谥 谥号
鳇	鳇 鳇鱼
斫	斫 斫轮老手
啮	啮 啮齿动物 啮齿 啮噬 啮合 啮齿类动物
芗	芗 芗城 芗城区
鹈	鹈 鹈鹕
岬	岬 岬角
氅	氅 氅衣
泅	泅 泅渡 泅水 泅泳 泅水而过
腧	腧 腧穴
鳟	鳟 鳟鱼
濠	濠 濠江 濠梁之上 濠沟 濠江区
淖	淖 淖尔
汜	汜 汜水镇
钣	钣 钣金件
缦	缦 缦杰
岷	岷 岷山 岷江 岷县
蘼	蘼 蘼芜
囿	囿 囿于 囿于成见 囿于一时
缙	缙 缙云 缙云山 缙绅 缙云县
妗	妗 妗子
胼	胼 胼手胝足 胼胝
硼	硼 硼砂 硼酸 硼钢
赭	赭 赭红 赭红色 赭石 赭石色 赭色
薜	薜 薜荔 薜萝
篾	篾 篾片 篾匠 篾条 篾席 篾笆
蚰	蚰 蚰蜒
蒺	蒺 蒺藜
衾	衾 衾影无惭
滦	滦 滦州 滦县 滦河 滦平 滦平县
娈	娈 娈童 娈童案
珙	珙 珙桐 珙县
蘅	蘅 蘅塘退士
僮	僮 僮仆 僮族
踯	踯 踯躅
漳	漳 漳州 漳河 漳浦 漳州市 漳县
秫	秫 秫秸 秫米
鲅	鲅 鲅鱼 鲅鱼圈 鲅鱼圈区
砭	砭 砭石 砭骨
秣	秣 秣马 秣马厉兵
肽	肽 肽键 肽链 肽聚糖 肽基 肽酶
缢	缢 缢死 缢痕
阈	阈 阈值 阈限 阈值条件 阈值电压
璩	璩 璩美凤
铨	铨 铨叙 铨考 铨叙部 铨衡 铨选
垩	垩 垩粉
趸	趸 趸船 趸批 趸售
缟	缟 缟素 缟衣
杲	杲 杲杲
藿	藿 藿香
烷	烷 烷基化 烷基 烷氧基 烷基苯 烷烃
濉	濉 濉溪 濉溪县
摈	摈 摈弃 摈除 摈斥
疣	疣 疣鼻天鹅
滁	滁 滁州 滁县 滁州市
镪	镪 镪水
蕲	蕲 蕲春 蕲蛇 蕲春县
鲷	鲷 鲷鱼
绶	绶 绶带 绶带鸟
锱	锱 锱铢必较 锱铢 锱珠必较 锱铢较量
杼	杼 杼轴
孀	孀 孀居 孀妇 孀妻弱子
懋	懋 懋功 懋勤殿 懋绩
锰	锰 锰钢 锰矿 锰铁
酰	酰 酰胺 酰胺键 酰亚胺 酰氯 酰基
郓	郓 郓城 郓城县
橛	橛 橛子
尥	尥 尥蹶子
锆	锆 锆石
氖	氖 氖气 氖灯
逶	逶 逶迤
疟	疟 疟疾 疟原虫 疟子 疟蚊 疟疾疫苗
疟	疟 疟疾 疟原虫 疟子 疟蚊 疟疾疫苗
酚	酚 酚酞 酚醛 酚醛树脂 酚类 酚妥拉明
邛	邛 邛海 邛崃 邛崃县 邛崃山 邛崃市
檩	檩 檩子 檩条 檩木
铣	铣 铣床 铣刀 铣工 铣铁 铣削
庠	庠 庠序
涪	涪 涪陵 涪城 涪江 涪陵市 涪陵区
伛	伛 伛偻
畿	畿 畿辅 畿内
扦	扦 扦插 扦子
畦	畦 畦田
沤	沤 沤肥
嫘	嫘 嫘祖
诤	诤 诤友 诤言 诤臣 诤讼 诤谏
轸	轸 轸念
莴	莴 莴笋 莴苣
彳	彳 彳亍
椋	椋 椋鸟
蚬	蚬 蚬壳
抟	抟 抟心壹志
獭	獭 獭兔 獭祭 獭皮
黜	黜 黜退 黜免 黜陟幽明 黜责
醪	醪 醪糟
枥	枥 枥木县
垓	垓 垓下
氦	氦 氦气
唿	唿 唿哨 唿扇
菏	菏 菏泽 菏泽市 菏泽地区
馔	馔 馔具
狎	狎 狎妓 狎侮 狎昵 狎客 狎玩
暹	暹 暹罗 暹罗人 暹罗湾 暹羅 暹粒
趺	趺 趺坐
猗	猗 猗顿
佶	佶 佶屈聱牙
榉	榉 榉树 榉木
铰	铰 铰链 铰接 铰刀
醴	醴 醴泉 醴陵
衽	衽 衽革枕戈
铵	铵 铵盐
鲥	鲥 鲥鱼
夥	夥 夥伴
柞	柞 柞树 柞木 柞蚕 柞蚕丝 柞丝
昝	昝 昝云龙
柞	柞 柞树 柞木 柞蚕 柞蚕丝 柞丝
啁	啁 啁啾
榫	榫 榫卯 榫头 榫子 榫眼
伉	伉 伉俪 伉俪情深 伉俪之情 伉儷
檑	檑 檑木
訾	訾 訾议
攮	攮 攮子
驽	驽 驽钝 驽马 驽马十驾 驽劣 驽弓
蓖	蓖 蓖麻 蓖麻子 蓖麻蚕 蓖麻油
盱	盱 盱眙 盱衡厉色 盱眙县
淝	淝 淝河
糨	糨 糨糊 糨子
郏	郏 郏县
悭	悭 悭吝
鸬	鸬 鸬鹚
穰	穰 穰穰满家
椴	椴 椴木 椴树 椴属
辎	辎 辎重
陟	陟 陟降 陟罚臧否
仵	仵 仵作 仵官 仵作一
髀	髀 髀肉复生 髀里肉生 髀关 髀骨
跬	跬 跬步 跬步千里
喹	喹 喹诺酮 喹啉
苄	苄 苄基
隰	隰 隰县
溴	溴 溴化物 溴化锂 溴水 溴化银 溴苯
氩	氩 氩弧焊 氩气
鄞	鄞 鄞县 鄞州区
芨	芨 芨芨草
砻	砻 砻谷 砻糠 砻市
楝	楝 楝树
呖	呖 呖呖
砬	砬 砬子
蓍	蓍 蓍草 蓍龟
錾	錾 錾子
酯	酯 酯化 酯交换 酯类
擢	擢 擢升 擢用 擢为 擢发难数
锺	锺 锺子期
旃	旃 旃檀
茼	茼 茼蒿 茼蒿菜
骠	骠 骠骑 骠勇
庹	庹 庹宗康 庹宗华
缂	缂 缂丝
骠	骠 骠骑 骠勇
榧	榧 榧子
怫	怫 怫然不悦 怫然作色
痈	痈 痈疽 痈肿 痈疮
疥	疥 疥疮 疥癣之疾 疥癣 疥虫
蛏	蛏 蛏子 蛏干
戕	戕 戕害 戕贼
桡	桡 桡骨 桡动脉
耦	耦 耦合 耦联 耦色 耦合度
疝	疝 疝气
坩	坩 坩埚 坩锅
桄	桄 桄榔
磙	磙 磙子
螽	螽 螽斯 螽斯衍庆
傩	傩 傩神 傩戏
鲇	鲇 鲇鱼
蓊	蓊 蓊蓊郁郁 蓊郁
飨	飨 飨客 飨宴
髌	髌 髌骨
揆	揆 揆情度理 揆时度势
溘	溘 溘然而逝 溘然长逝 溘然 溘逝
僖	僖 僖宗
檄	檄 檄文 檄书
鲱	鲱 鲱鱼
呋	呋 呋喃 呋喃丹 呋喃妥因 呋喃唑酮 呋喃西林
徭	徭 徭役
掎	掎 掎角之势 掎裳连襼
镢	镢 镢头
疱	疱 疱疹 疱疹病毒
熘	熘 熘鱼片 熘肝尖
溧	溧 溧水 溧阳 溧水县 溧阳县 溧阳市
澧	澧 澧水 澧县
鞣	鞣 鞣制 鞣酸 鞣质 鞣料 鞣剂
褡	褡 褡裢 褡包 褡扣 褡连
圪	圪 圪塔 圪节 圪台
舢	舢 舢板
矸	矸 矸石
骈	骈 骈文 骈四俪六 骈体 骈俪 骈体文
畚	畚 畚斗 畚箕
眄	眄 眄视指使
螨	螨 螨虫
钽	钽 钽电容
霪	霪 霪雨
纡	纡 纡回 纡尊降贵 纡朱怀金 纡青佩紫 纡子
鳙	鳙 鳙鱼
剡	剡 剡溪
疖	疖 疖子
狷	狷 狷介之士
赍	赍 赍志而没
茭	茭 茭白
鸱	鸱 鸱尾 鸱吻 鸱鴞 鸱枭 鸱视狼顾
牝	牝 牝马 牝鸡 牝牛 牝鹿 牝牡骊黄
砗	砗 砗磲
愆	愆 愆期 愆尤
遴	遴 遴选 遴选出 遴选出来
螫	螫 螫人 螫毒 螫针
诰	诰 诰命 诰封
剡	剡 剡溪
潲	潲 潲水 潲雨
笊	笊 笊篱
潴	潴 潴留 潴龙河
瘢	瘢 瘢痕
鳔	鳔 鳔胶
篦	篦 篦子 篦麻 篦麻子
嘧	嘧 嘧啶
拊	拊 拊心泣血 拊膺顿足
锑	锑 锑矿
揠	揠 揠苗助长
龃	龃 龃龉 龃齿
郫	郫 郫县
侪	侪 侪辈
茌	茌 茌平县 茌平
阒	阒 阒无一人 阒寂 阒无人声 阒然无声 阒寂无声
挈	挈 挈瓶之知
龋	龋 龋齿
镏	镏 镏金 镏子
荦	荦 荦荦大者 荦荦大端 荦荦
儋	儋 儋州 儋州市 儋县
畲	畲 畲族
菽	菽 菽粟 菽麦 菽庄花园 菽水承欢
脲	脲 脲醛树脂
嗉	嗉 嗉囊 嗉子
橐	橐 橐驼
栲	栲 栲栳 栲胶
呒	呒 呒啥
颟	颟 颟顸 颟顸无能
缬	缬 缬氨酸 缬草 缬沙坦
阋	阋 阋墙
硒	硒 硒鼓
讣	讣 讣告 讣闻 讣文 讣告作者
鲂	鲂 鲂鱼赪尾
郯	郯 郯城 郯城县
矾	矾 矾石 矾土
鲳	鲳 鲳鱼
踔	踔 踔绝之能 踔厉风发 踔厉奋发
莼	莼 莼菜 莼鲈之思
钤	钤 钤记 钤印
炔	炔 炔诺酮 炔雌醚
鏊	鏊 鏊子
鲮	鲮 鲮鱼 鲮鲤
痤	痤 痤疮
嵯	嵯 嵯峨
腠	腠 腠理
骖	骖 骖鸾驭鹤
黩	黩 黩武 黩武穷兵
碓	碓 碓房
痼	痼 痼疾 痼癖
绀	绀 绀青
鹳	鹳 鹳雀楼 鹳雀 鹳山
糌	糌 糌粑
觳	觳 觳觫
黧	黧 黧黑
秭	秭 秭归 秭归县
瘿	瘿 瘿瘤
髋	髋 髋部 髋骨 髋关节 髋臼
鳊	鳊 鳊鱼
沔	沔 沔阳 沔阳县
岘	岘 岘港
崤	崤 崤函之固
硖	硖 硖石
仡	仡 仡佬 仡佬族
铱	铱 铱金 铱金笔 铱星
蚜	蚜 蚜虫
芫	芫 芫荽 芫花
壅	壅 壅塞 壅蔽
鄄	鄄 鄄城 鄄城县
嘌	嘌 嘌呤
惝	惝 惝恍 惝恍迷离
愀	愀 愀然变色 愀然不乐
骶	骶 骶骨 骶椎
酢	酢 酢浆草 酢酱草
蹀	蹀 蹀躞
仡	仡 仡佬 仡佬族
炻	炻 炻器
嬗	嬗 嬗变
酢	酢 酢浆草 酢酱草
孳	孳 孳生 孳息 孳乳 孳生地
蟪	蟪 蟪蛄
帏	帏 帏幕
馓	馓 馓子
颞	颞 颞叶 颞骨 颞颥
暌	暌 暌违
锔	锔 锔锅匠
蛞	蛞 蛞蝓
蠓	蠓 蠓虫
醯	醯 醯胺
囟	囟 囟门
羰	羰 羰基
挹	挹 挹注 挹娄
狺	狺 狺狺狂吠
悒	悒 悒郁 悒悒 悒悒不乐 悒然 悒郁寡欢
苣	苣 苣荬菜
邳	邳 邳县 邳州 邳州市
俳	俳 俳句 俳优
柽	柽 柽柳
褫	褫 褫夺 褫夺公权
揿	揿 揿下 揿住 揿钮 揿扭
苘	苘 苘麻
苣	苣 苣荬菜
瘘	瘘 瘘管
傈	傈 傈僳族 傈僳
髑	髑 髑髅
氘	氘 氘核
嵊	嵊 嵊县 嵊州 嵊泗县 嵊州市 嵊泗
臌	臌 臌胀
栝	栝 栝楼
芟	芟 芟除 芟夷
怙	怙 怙恶不悛 怙恃 怙恩恃宠 怙终不悛
跖	跖 跖骨
畹	畹 畹町
铙	铙 铙钹
筚	筚 筚路蓝缕 筚篥 筚路褴褛 筚门闺窦
艨	艨 艨艟
仫	仫 仫佬族 仫佬
侔	侔 侔色揣称
钼	钼 钼钢 钼矿
黾	黾 黾勉
籼	籼 籼米 籼稻
饧	饧 饧糖
蜩	蜩 蜩螗沸羹
漯	漯 漯河 漯河市
粳	粳 粳米 粳稻
鲣	鲣 鲣鱼 鲣鸟
跏	跏 跏趺
鹣	鹣 鹣鲽情深
蛱	蛱 蛱蝶
苤	苤 苤蓝
羟	羟 羟色胺 羟基 羟磷灰石 羟脯氨酸 羟乙
袷	袷 袷袢
聱	聱 聱牙诘屈 聱牙
锕	锕 锕系元素
漯	漯 漯河 漯河市
凼	凼 凼仔岛
绲	绲 绲边
撙	撙 撙节
舴	舴 舴艋
槲	槲 槲栎 槲寄生
髭	髭 髭须 髭毛
舳	舳 舳舻 舳舻相继
苎	苎 苎麻根 苎麻
羧	羧 羧基 羧酸 羧化酶 羧化 羧甲基
桫	桫 桫椤 桫椤树
哌	哌 哌啶 哌嗪 哌替啶
旰	旰 旰食宵衣 旰食
蜣	蜣 蜣螂
邴	邴 邴元真
箅	箅 箅子
鹁	鹁 鹁鸪 鹁鸽
悃	悃 悃愊无华
舾	舾 舾装
艴	艴 艴然不悦
梃	梃 梃击案
枋	枋 枋湖 枋头 枋山 枋寮
烃	烃 烃类
滏	滏 滏阳
鬻	鬻 鬻文为生 鬻儿卖女
阏	阏 阏氏
燠	燠 燠热
蕺	蕺 蕺菜
冁	冁 冁然而笑
樗	樗 樗蒲 樗栎庸材
裒	裒 裒多益寡
髂	髂 髂骨
桤	桤 桤木
瘰	瘰 瘰疬
癃	癃 癃闭
辚	辚 辚辚
鹩	鹩 鹩哥
溽	溽 溽热 溽暑
稂	稂 稂莠不齐
莪	莪 莪术
谠	谠 谠论侃侃
箪	箪 箪瓢屡空 箪食瓢饮 箪食壶浆 箪食壶酒
羝	羝 羝羊触藩
疳	疳 疳积 疳疮
筲	筲 筲箕
虼	虼 虼蚤
澉	澉 澉浦 澉浦镇
蒴	蒴 蒴果
瘊	瘊 瘊子
蚶	蚶 蚶子 蚶田
砟	砟 砟子
胬	胬 胬肉
酞	酞 酞菁
趑	趑 趑趄 趑趄不前
膂	膂 膂力 膂力过人
傧	傧 傧相
岢	岢 岢岚
杓	杓 杓子
秕	秕 秕糠 秕子 秕谷 秕政
菝	菝 菝葜
芤	芤 芤脉
跣	跣 跣足
垡	垡 垡头
桴	桴 桴鼓相应
瘗	瘗 瘗玉埋香
饫	饫 饫甘餍肥
夤	夤 夤夜 夤缘 夤缘攀附
峄	峄 峄城区 峄城
郧	郧 郧阳 郧西 郧县 郧西县
饔	饔 饔飧不继 饔飧不济
踺	踺 踺子
腈	腈 腈纶
氆	氆 氆氇
筢	筢 筢子
笸	笸 笸箩 笸篮
耪	耪 耪地
汊	汊 汊港 汊流
茺	茺 茺蔚子
筇	筇 筇竹
鸲	鸲 鸲鹆
劬	劬 劬劳
佥	佥 佥都御史
缧	缧 缧绁
鸸	鸸 鸸鹋
裣	裣 裣衽
蝾	蝾 蝾螈
杓	杓 杓子
畛	畛 畛域
缫	缫 缫丝 缫丝厂 缫丝机
蛲	蛲 蛲虫
怃	怃 怃然
